id,county,st,year,total,noncitizen,citizen,rate
01001,"Autauga County, Alabama",NA,2023,59285,702,58583,1.184110652
01003,"Baldwin County, Alabama",NA,2023,239945,5145,234800,2.144241389
01005,"Barbour County, Alabama",NA,2023,24757,423,24334,1.708607667
01007,"Bibb County, Alabama",NA,2023,22152,232,21920,1.047309498
01009,"Blount County, Alabama",NA,2023,59292,1743,57549,2.939688322
01011,"Bullock County, Alabama",NA,2023,10157,211,9946,2.077385055
01013,"Butler County, Alabama",NA,2023,18807,137,18670,0.728452172
01015,"Calhoun County, Alabama",NA,2023,116141,1432,114709,1.232984045
01017,"Chambers County, Alabama",NA,2023,34450,823,33627,2.388969521
01019,"Cherokee County, Alabama",NA,2023,25224,321,24903,1.272597526
01021,"Chilton County, Alabama",NA,2023,45500,1191,44309,2.617582418
01023,"Choctaw County, Alabama",NA,2023,12525,41,12484,0.327345309
01025,"Clarke County, Alabama",NA,2023,22802,105,22697,0.460485922
01027,"Clay County, Alabama",NA,2023,14188,65,14123,0.458133634
01029,"Cleburne County, Alabama",NA,2023,15254,39,15215,0.255670644
01031,"Coffee County, Alabama",NA,2023,54231,1398,52833,2.577861371
01033,"Colbert County, Alabama",NA,2023,57648,536,57112,0.929780738
01035,"Conecuh County, Alabama",NA,2023,11411,33,11378,0.289194637
01037,"Coosa County, Alabama",NA,2023,10323,20,10303,0.193742129
01039,"Covington County, Alabama",NA,2023,37647,208,37439,0.552500863
01041,"Crenshaw County, Alabama",NA,2023,13144,127,13017,0.966220329
01043,"Cullman County, Alabama",NA,2023,89463,1382,88081,1.544772699
01045,"Dale County, Alabama",NA,2023,49516,741,48775,1.496485984
01047,"Dallas County, Alabama",NA,2023,37536,359,37177,0.956415175
01049,"DeKalb County, Alabama",NA,2023,71946,4181,67765,5.811302922
01051,"Elmore County, Alabama",NA,2023,88669,1105,87564,1.246207807
01053,"Escambia County, Alabama",NA,2023,36695,65,36630,0.17713585
01055,"Etowah County, Alabama",NA,2023,103208,1538,101670,1.490194559
01057,"Fayette County, Alabama",NA,2023,16173,0,16173,0
01059,"Franklin County, Alabama",NA,2023,31978,1644,30334,5.141034461
01061,"Geneva County, Alabama",NA,2023,26726,257,26469,0.961610417
01063,"Greene County, Alabama",NA,2023,7589,8,7581,0.105415733
01065,"Hale County, Alabama",NA,2023,14749,21,14728,0.142382534
01067,"Henry County, Alabama",NA,2023,17450,37,17413,0.212034384
01069,"Houston County, Alabama",NA,2023,107628,1789,105839,1.662206861
01071,"Jackson County, Alabama",NA,2023,52839,527,52312,0.997369367
01073,"Jefferson County, Alabama",NA,2023,669744,19628,650116,2.930672018
01075,"Lamar County, Alabama",NA,2023,13809,42,13767,0.304149468
01077,"Lauderdale County, Alabama",NA,2023,95037,1596,93441,1.679345939
01079,"Lawrence County, Alabama",NA,2023,33182,286,32896,0.861913085
01081,"Lee County, Alabama",NA,2023,177663,7296,170367,4.106651357
01083,"Limestone County, Alabama",NA,2023,107577,1979,105598,1.839612557
01085,"Lowndes County, Alabama",NA,2023,10008,69,9939,0.689448441
01087,"Macon County, Alabama",NA,2023,18951,156,18795,0.823175558
01089,"Madison County, Alabama",NA,2023,397135,11444,385691,2.881639745
01091,"Marengo County, Alabama",NA,2023,19027,126,18901,0.66221685
01093,"Marion County, Alabama",NA,2023,29190,120,29070,0.411099692
01095,"Marshall County, Alabama",NA,2023,98712,4949,93763,5.013574844
01097,"Mobile County, Alabama",NA,2023,413162,5958,407204,1.442049366
01099,"Monroe County, Alabama",NA,2023,19580,26,19554,0.13278856
01101,"Montgomery County, Alabama",NA,2023,227197,7970,219227,3.507968855
01103,"Morgan County, Alabama",NA,2023,123742,4854,118888,3.92267783
01105,"Perry County, Alabama",NA,2023,8231,39,8192,0.473818491
01107,"Pickens County, Alabama",NA,2023,18843,641,18202,3.40179377
01109,"Pike County, Alabama",NA,2023,32953,730,32223,2.215276303
01111,"Randolph County, Alabama",NA,2023,22310,156,22154,0.69923801
01113,"Russell County, Alabama",NA,2023,58858,654,58204,1.111148867
01115,"St. Clair County, Alabama",NA,2023,92903,716,92187,0.770696318
01117,"Shelby County, Alabama",NA,2023,226955,6631,220324,2.921724571
01119,"Sumter County, Alabama",NA,2023,12020,54,11966,0.449251248
01121,"Talladega County, Alabama",NA,2023,81170,1000,80170,1.231982259
01123,"Tallapoosa County, Alabama",NA,2023,41070,487,40583,1.185780375
01125,"Tuscaloosa County, Alabama",NA,2023,234036,6145,227891,2.625664428
01127,"Walker County, Alabama",NA,2023,64886,704,64182,1.084979811
01129,"Washington County, Alabama",NA,2023,15270,49,15221,0.320890635
01131,"Wilcox County, Alabama",NA,2023,10347,4,10343,0.038658548
01133,"Winston County, Alabama",NA,2023,23637,365,23272,1.544189195
02013,"Aleutians East Borough, Alaska",NA,2023,3423,738,2685,21.56003506
02016,"Aleutians West Census Area, Alaska",NA,2023,5178,1269,3909,24.50753187
02020,"Anchorage Municipality, Alaska",NA,2023,289069,11037,278032,3.818119549
02050,"Bethel Census Area, Alaska",NA,2023,18487,152,18335,0.822199383
02060,"Bristol Bay Borough, Alaska",NA,2023,878,42,836,4.783599089
02063,"Chugach Census Area, Alaska",NA,2023,6964,129,6835,1.852383688
02066,"Copper River Census Area, Alaska",NA,2023,2626,19,2607,0.723533892
02068,"Denali Borough, Alaska",NA,2023,2029,64,1965,3.154263184
02070,"Dillingham Census Area, Alaska",NA,2023,4780,58,4722,1.213389121
02090,"Fairbanks North Star Borough, Alaska",NA,2023,95555,2292,93263,2.398618597
02100,"Haines Borough, Alaska",NA,2023,2077,74,2003,3.562831006
02105,"Hoonah-Angoon Census Area, Alaska",NA,2023,2313,33,2280,1.426718547
02110,"Juneau City and Borough, Alaska",NA,2023,31969,778,31191,2.433607557
02122,"Kenai Peninsula Borough, Alaska",NA,2023,59843,757,59086,1.264976689
02130,"Ketchikan Gateway Borough, Alaska",NA,2023,13870,351,13519,2.530641673
02150,"Kodiak Island Borough, Alaska",NA,2023,12878,1258,11620,9.768597608
02158,"Kusilvak Census Area, Alaska",NA,2023,8277,38,8239,0.45910354
02164,"Lake and Peninsula Borough, Alaska",NA,2023,1007,46,961,4.568023833
02170,"Matanuska-Susitna Borough, Alaska",NA,2023,110677,1054,109623,0.952320717
02180,"Nome Census Area, Alaska",NA,2023,9925,75,9850,0.755667506
02185,"North Slope Borough, Alaska",NA,2023,10891,329,10562,3.020842898
02188,"Northwest Arctic Borough, Alaska",NA,2023,7611,160,7451,2.10222047
02195,"Petersburg Borough, Alaska",NA,2023,3394,176,3218,5.185621685
02198,"Prince of Wales-Hyder Census Area, Alaska",NA,2023,5730,60,5670,1.047120419
02220,"Sitka City and Borough, Alaska",NA,2023,8393,449,7944,5.349696175
02230,"Skagway Municipality, Alaska",NA,2023,1308,36,1272,2.752293578
02240,"Southeast Fairbanks Census Area, Alaska",NA,2023,6936,253,6683,3.647635525
02275,"Wrangell City and Borough, Alaska",NA,2023,2106,71,2035,3.371320038
02282,"Yakutat City and Borough, Alaska",NA,2023,506,68,438,13.43873518
02290,"Yukon-Koyukuk Census Area, Alaska",NA,2023,5271,73,5198,1.384936445
04001,"Apache County, Arizona",NA,2023,65680,489,65191,0.744518879
04003,"Cochise County, Arizona",NA,2023,125458,5230,120228,4.168725789
04005,"Coconino County, Arizona",NA,2023,144643,3606,141037,2.493034575
04007,"Gila County, Arizona",NA,2023,53610,651,52959,1.214325686
04009,"Graham County, Arizona",NA,2023,38860,495,38365,1.273803397
04011,"Greenlee County, Arizona",NA,2023,9452,171,9281,1.809140923
04012,"La Paz County, Arizona",NA,2023,16605,1090,15515,6.564287865
04013,"Maricopa County, Arizona",NA,2023,4491987,346232,4145755,7.707769413
04015,"Mohave County, Arizona",NA,2023,217420,5158,212262,2.372366848
04017,"Navajo County, Arizona",NA,2023,107744,1123,106621,1.042285417
04019,"Pima County, Arizona",NA,2023,1049947,57242,992705,5.451894238
04021,"Pinal County, Arizona",NA,2023,449219,21094,428125,4.695705213
04023,"Santa Cruz County, Arizona",NA,2023,48209,6445,41764,13.36887303
04025,"Yavapai County, Arizona",NA,2023,241656,7782,233874,3.220280068
04027,"Yuma County, Arizona",NA,2023,207685,27468,180217,13.22579869
05001,"Arkansas County, Arkansas",NA,2023,16773,149,16624,0.888332439
05003,"Ashley County, Arkansas",NA,2023,18722,277,18445,1.479542784
05005,"Baxter County, Arkansas",NA,2023,42150,257,41893,0.609727165
05007,"Benton County, Arkansas",NA,2023,294541,24293,270248,8.247748191
05009,"Boone County, Arkansas",NA,2023,37896,338,37558,0.891914714
05011,"Bradley County, Arkansas",NA,2023,10354,492,9862,4.751786749
05013,"Calhoun County, Arkansas",NA,2023,4717,40,4677,0.847996608
05015,"Carroll County, Arkansas",NA,2023,28526,1871,26655,6.558928697
05017,"Chicot County, Arkansas",NA,2023,9997,117,9880,1.170351105
05019,"Clark County, Arkansas",NA,2023,21378,278,21100,1.300402283
05021,"Clay County, Arkansas",NA,2023,14399,56,14343,0.388915897
05023,"Cleburne County, Arkansas",NA,2023,25048,143,24905,0.570903865
05025,"Cleveland County, Arkansas",NA,2023,7491,12,7479,0.160192231
05027,"Columbia County, Arkansas",NA,2023,22527,359,22168,1.593643184
05029,"Conway County, Arkansas",NA,2023,20872,340,20532,1.628976619
05031,"Craighead County, Arkansas",NA,2023,112097,2566,109531,2.289088914
05033,"Crawford County, Arkansas",NA,2023,60792,1279,59513,2.103895249
05035,"Crittenden County, Arkansas",NA,2023,47609,529,47080,1.111134449
05037,"Cross County, Arkansas",NA,2023,16681,235,16446,1.408788442
05039,"Dallas County, Arkansas",NA,2023,6351,19,6332,0.299165486
05041,"Desha County, Arkansas",NA,2023,11041,213,10828,1.929173082
05043,"Drew County, Arkansas",NA,2023,17143,279,16864,1.627486438
05045,"Faulkner County, Arkansas",NA,2023,126001,2645,123356,2.099189689
05047,"Franklin County, Arkansas",NA,2023,17220,81,17139,0.470383275
05049,"Fulton County, Arkansas",NA,2023,12239,38,12201,0.310482883
05051,"Garland County, Arkansas",NA,2023,100062,2336,97726,2.334552577
05053,"Grant County, Arkansas",NA,2023,18111,203,17908,1.120865772
05055,"Greene County, Arkansas",NA,2023,46182,308,45874,0.666926508
05057,"Hempstead County, Arkansas",NA,2023,19778,1093,18685,5.526342401
05059,"Hot Spring County, Arkansas",NA,2023,33142,102,33040,0.30776658
05061,"Howard County, Arkansas",NA,2023,12701,729,11972,5.739705535
05063,"Independence County, Arkansas",NA,2023,38120,881,37239,2.31112277
05065,"Izard County, Arkansas",NA,2023,13866,57,13809,0.411077456
05067,"Jackson County, Arkansas",NA,2023,16775,102,16673,0.60804769
05069,"Jefferson County, Arkansas",NA,2023,65780,780,65000,1.185770751
05071,"Johnson County, Arkansas",NA,2023,25932,1534,24398,5.915471232
05073,"Lafayette County, Arkansas",NA,2023,6211,7,6204,0.112703268
05075,"Lawrence County, Arkansas",NA,2023,16265,99,16166,0.608668921
05077,"Lee County, Arkansas",NA,2023,8511,32,8479,0.375984021
05079,"Lincoln County, Arkansas",NA,2023,12966,249,12717,1.920407219
05081,"Little River County, Arkansas",NA,2023,11959,35,11924,0.292666611
05083,"Logan County, Arkansas",NA,2023,21240,126,21114,0.593220339
05085,"Lonoke County, Arkansas",NA,2023,74747,957,73790,1.280318943
05087,"Madison County, Arkansas",NA,2023,17032,396,16636,2.325035228
05089,"Marion County, Arkansas",NA,2023,17076,172,16904,1.007261654
05091,"Miller County, Arkansas",NA,2023,42588,263,42325,0.617544848
05093,"Mississippi County, Arkansas",NA,2023,39749,536,39213,1.348461597
05095,"Monroe County, Arkansas",NA,2023,6681,57,6624,0.853165694
05097,"Montgomery County, Arkansas",NA,2023,8571,154,8417,1.796756504
05099,"Nevada County, Arkansas",NA,2023,8228,9,8219,0.109382596
05101,"Newton County, Arkansas",NA,2023,7175,7,7168,0.097560976
05103,"Ouachita County, Arkansas",NA,2023,22317,42,22275,0.188197338
05105,"Perry County, Arkansas",NA,2023,10073,62,10011,0.6155068
05107,"Phillips County, Arkansas",NA,2023,15910,176,15734,1.106222502
05109,"Pike County, Arkansas",NA,2023,10182,335,9847,3.290119819
05111,"Poinsett County, Arkansas",NA,2023,22740,199,22541,0.875109938
05113,"Polk County, Arkansas",NA,2023,19348,466,18882,2.408517676
05115,"Pope County, Arkansas",NA,2023,63830,1979,61851,3.100422999
05117,"Prairie County, Arkansas",NA,2023,8162,14,8148,0.171526587
05119,"Pulaski County, Arkansas",NA,2023,398949,14815,384134,3.71350724
05121,"Randolph County, Arkansas",NA,2023,18733,437,18296,2.332781722
05123,"St. Francis County, Arkansas",NA,2023,22740,386,22354,1.697449428
05125,"Saline County, Arkansas",NA,2023,125724,2743,122981,2.181763227
05127,"Scott County, Arkansas",NA,2023,9839,109,9730,1.107836162
05129,"Searcy County, Arkansas",NA,2023,7861,27,7834,0.343467752
05131,"Sebastian County, Arkansas",NA,2023,128448,6363,122085,4.953755605
05133,"Sevier County, Arkansas",NA,2023,15797,2056,13741,13.01512945
05135,"Sharp County, Arkansas",NA,2023,17597,104,17493,0.591009831
05137,"Stone County, Arkansas",NA,2023,12474,33,12441,0.264550265
05139,"Union County, Arkansas",NA,2023,38368,616,37752,1.605504587
05141,"Van Buren County, Arkansas",NA,2023,15936,189,15747,1.185993976
05143,"Washington County, Arkansas",NA,2023,251863,20938,230925,8.313249664
05145,"White County, Arkansas",NA,2023,77395,1068,76327,1.379934104
05147,"Woodruff County, Arkansas",NA,2023,6157,19,6138,0.308591847
05149,"Yell County, Arkansas",NA,2023,20195,1108,19087,5.486506561
06001,"Alameda County, California",NA,2023,1651949,251650,1400299,15.23352113
06003,"Alpine County, California",NA,2023,1695,23,1672,1.356932153
06005,"Amador County, California",NA,2023,41029,900,40129,2.193570401
06007,"Butte County, California",NA,2023,209470,7289,202181,3.479734568
06009,"Calaveras County, California",NA,2023,45995,1291,44704,2.806826829
06011,"Colusa County, California",NA,2023,21895,3609,18286,16.48321535
06013,"Contra Costa County, California",NA,2023,1161458,126746,1034712,10.91266322
06015,"Del Norte County, California",NA,2023,27293,954,26339,3.495401751
06017,"El Dorado County, California",NA,2023,192299,7508,184791,3.904336476
06019,"Fresno County, California",NA,2023,1012152,104473,907679,10.32186865
06021,"Glenn County, California",NA,2023,28623,2580,26043,9.013730217
06023,"Humboldt County, California",NA,2023,135418,4059,131359,2.997385872
06025,"Imperial County, California",NA,2023,179319,25747,153572,14.35821079
06027,"Inyo County, California",NA,2023,18803,893,17910,4.749242142
06029,"Kern County, California",NA,2023,910433,106839,803594,11.73496567
06031,"Kings County, California",NA,2023,152830,18514,134316,12.11411372
06033,"Lake County, California",NA,2023,68139,3282,64857,4.81662484
06035,"Lassen County, California",NA,2023,31177,1341,29836,4.301247715
06037,"Los Angeles County, California",NA,2023,9848406,1490299,8358107,15.13238792
06039,"Madera County, California",NA,2023,158790,20856,137934,13.13432836
06041,"Marin County, California",NA,2023,258765,24658,234107,9.529109424
06043,"Mariposa County, California",NA,2023,17060,775,16285,4.542790152
06045,"Mendocino County, California",NA,2023,90709,6271,84438,6.913316209
06047,"Merced County, California",NA,2023,285597,43127,242470,15.10064882
06049,"Modoc County, California",NA,2023,8646,283,8363,3.273189914
06051,"Mono County, California",NA,2023,13169,1645,11524,12.49145721
06053,"Monterey County, California",NA,2023,435834,87281,348553,20.02620264
06055,"Napa County, California",NA,2023,136070,13296,122774,9.77144117
06057,"Nevada County, California",NA,2023,102452,3503,98949,3.419162144
06059,"Orange County, California",NA,2023,3164063,394578,2769485,12.47061136
06061,"Placer County, California",NA,2023,412435,18282,394153,4.432698486
06063,"Plumas County, California",NA,2023,19607,184,19423,0.938440353
06065,"Riverside County, California",NA,2023,2449909,233571,2216338,9.533864319
06067,"Sacramento County, California",NA,2023,1584047,137381,1446666,8.672785593
06069,"San Benito County, California",NA,2023,66056,6744,59312,10.2095192
06071,"San Bernardino County, California",NA,2023,2187816,220902,1966914,10.09691857
06073,"San Diego County, California",NA,2023,3282782,299987,2982795,9.138194373
06075,"San Francisco County, California",NA,2023,836321,106576,729745,12.74343225
06077,"San Joaquin County, California",NA,2023,787416,91705,695711,11.64632164
06079,"San Luis Obispo County, California",NA,2023,281486,13041,268445,4.632912472
06081,"San Mateo County, California",NA,2023,745100,109733,635367,14.72728493
06083,"Santa Barbara County, California",NA,2023,443975,59444,384531,13.38904218
06085,"Santa Clara County, California",NA,2023,1903297,367846,1535451,19.32677874
06087,"Santa Cruz County, California",NA,2023,266021,25204,240817,9.474439988
06089,"Shasta County, California",NA,2023,181554,4159,177395,2.290778501
06091,"Sierra County, California",NA,2023,2731,63,2668,2.306847309
06093,"Siskiyou County, California",NA,2023,43834,987,42847,2.251676781
06095,"Solano County, California",NA,2023,450824,38723,412101,8.589382996
06097,"Sonoma County, California",NA,2023,485642,41928,443714,8.633520165
06099,"Stanislaus County, California",NA,2023,552250,59219,493031,10.72322318
06101,"Sutter County, California",NA,2023,98971,10396,88575,10.50408706
06103,"Tehama County, California",NA,2023,65520,4067,61453,6.207264957
06105,"Trinity County, California",NA,2023,15886,313,15573,1.970288304
06107,"Tulare County, California",NA,2023,475774,64170,411604,13.48749616
06109,"Tuolumne County, California",NA,2023,54873,932,53941,1.69846737
06111,"Ventura County, California",NA,2023,838259,86085,752174,10.26949905
06113,"Yolo County, California",NA,2023,217782,23286,194496,10.69234372
06115,"Yuba County, California",NA,2023,83079,3578,79501,4.306744183
08001,"Adams County, Colorado",NA,2023,524408,50991,473417,9.723535873
08003,"Alamosa County, Colorado",NA,2023,16515,469,16046,2.839842567
08005,"Arapahoe County, Colorado",NA,2023,655709,52881,602828,8.064705532
08007,"Archuleta County, Colorado",NA,2023,13730,282,13448,2.053896577
08009,"Baca County, Colorado",NA,2023,3460,82,3378,2.369942197
08011,"Bent County, Colorado",NA,2023,5524,132,5392,2.389572773
08013,"Boulder County, Colorado",NA,2023,328317,16458,311859,5.012838202
08014,"Broomfield County, Colorado",NA,2023,75110,3437,71673,4.575955266
08015,"Chaffee County, Colorado",NA,2023,19876,315,19561,1.584825921
08017,"Cheyenne County, Colorado",NA,2023,1732,99,1633,5.715935335
08019,"Clear Creek County, Colorado",NA,2023,9358,78,9280,0.833511434
08021,"Conejos County, Colorado",NA,2023,7536,116,7420,1.539278132
08023,"Costilla County, Colorado",NA,2023,3571,145,3426,4.060487258
08025,"Crowley County, Colorado",NA,2023,5734,27,5707,0.47087548
08027,"Custer County, Colorado",NA,2023,5073,74,4999,1.458702937
08029,"Delta County, Colorado",NA,2023,31353,431,30922,1.374669091
08031,"Denver County, Colorado",NA,2023,713734,52627,661107,7.373475272
08033,"Dolores County, Colorado",NA,2023,2385,9,2376,0.377358491
08035,"Douglas County, Colorado",NA,2023,368283,12433,355850,3.37593644
08037,"Eagle County, Colorado",NA,2023,55374,4654,50720,8.40466645
08039,"Elbert County, Colorado",NA,2023,27152,328,26824,1.208014143
08041,"El Paso County, Colorado",NA,2023,736008,20071,715937,2.727008402
08043,"Fremont County, Colorado",NA,2023,49394,557,48837,1.127667328
08045,"Garfield County, Colorado",NA,2023,62034,5291,56743,8.529193668
08047,"Gilpin County, Colorado",NA,2023,5877,222,5655,3.777437468
08049,"Grand County, Colorado",NA,2023,15794,351,15443,2.222362923
08051,"Gunnison County, Colorado",NA,2023,17158,195,16963,1.136496095
08053,"Hinsdale County, Colorado",NA,2023,939,0,939,0
08055,"Huerfano County, Colorado",NA,2023,6946,0,6946,0
08057,"Jackson County, Colorado",NA,2023,1422,0,1422,0
08059,"Jefferson County, Colorado",NA,2023,579715,15166,564549,2.61611309
08061,"Kiowa County, Colorado",NA,2023,1356,39,1317,2.876106195
08063,"Kit Carson County, Colorado",NA,2023,7015,301,6714,4.290805417
08065,"Lake County, Colorado",NA,2023,7411,649,6762,8.757252732
08067,"La Plata County, Colorado",NA,2023,56088,649,55439,1.157110255
08069,"Larimer County, Colorado",NA,2023,363561,9424,354137,2.59213722
08071,"Las Animas County, Colorado",NA,2023,14392,340,14052,2.362423569
08073,"Lincoln County, Colorado",NA,2023,5561,133,5428,2.391656177
08075,"Logan County, Colorado",NA,2023,21067,575,20492,2.729387193
08077,"Mesa County, Colorado",NA,2023,157316,4038,153278,2.566808208
08079,"Mineral County, Colorado",NA,2023,799,0,799,0
08081,"Moffat County, Colorado",NA,2023,13258,381,12877,2.873736612
08083,"Montezuma County, Colorado",NA,2023,26204,516,25688,1.969165013
08085,"Montrose County, Colorado",NA,2023,43272,1939,41333,4.480957663
08087,"Morgan County, Colorado",NA,2023,29186,2478,26708,8.490372096
08089,"Otero County, Colorado",NA,2023,18460,307,18153,1.663055255
08091,"Ouray County, Colorado",NA,2023,5024,64,4960,1.27388535
08093,"Park County, Colorado",NA,2023,17739,113,17626,0.637014488
08095,"Phillips County, Colorado",NA,2023,4491,369,4122,8.216432866
08097,"Pitkin County, Colorado",NA,2023,17119,993,16126,5.800572463
08099,"Prowers County, Colorado",NA,2023,11931,577,11354,4.836141145
08101,"Pueblo County, Colorado",NA,2023,168726,3908,164818,2.316181264
08103,"Rio Blanco County, Colorado",NA,2023,6518,186,6332,2.853636085
08105,"Rio Grande County, Colorado",NA,2023,11394,477,10917,4.186413902
08107,"Routt County, Colorado",NA,2023,24990,705,24285,2.821128451
08109,"Saguache County, Colorado",NA,2023,6511,206,6305,3.163876517
08111,"San Juan County, Colorado",NA,2023,690,57,633,8.260869565
08113,"San Miguel County, Colorado",NA,2023,8026,334,7692,4.161475206
08115,"Sedgwick County, Colorado",NA,2023,2346,64,2282,2.728047741
08117,"Summit County, Colorado",NA,2023,30857,2047,28810,6.633827008
08119,"Teller County, Colorado",NA,2023,24774,215,24559,0.867845322
08121,"Washington County, Colorado",NA,2023,4839,121,4718,2.500516636
08123,"Weld County, Colorado",NA,2023,340711,18241,322470,5.353804251
08125,"Yuma County, Colorado",NA,2023,9921,1403,8518,14.14171958
09110,"Capitol Planning Region, Connecticut",NA,2023,969029,58988,910041,6.08733072
09120,"Greater Bridgeport Planning Region, Connecticut",NA,2023,326296,35409,290887,10.85180327
09130,"Lower Connecticut River Valley Planning Region, Connecticut",NA,2023,174983,5020,169963,2.868850117
09140,"Naugatuck Valley Planning Region, Connecticut",NA,2023,452303,24753,427550,5.472658815
09150,"Northeastern Connecticut Planning Region, Connecticut",NA,2023,95829,1944,93885,2.028613468
09160,"Northwest Hills Planning Region, Connecticut",NA,2023,112848,3944,108904,3.494966681
09170,"South Central Connecticut Planning Region, Connecticut",NA,2023,566803,36096,530707,6.368350203
09180,"Southeastern Connecticut Planning Region, Connecticut",NA,2023,279025,10455,268570,3.746976077
09190,"Western Connecticut Planning Region, Connecticut",NA,2023,621232,70605,550627,11.36531924
10001,"Kent County, Delaware",NA,2023,185043,5256,179787,2.840420875
10003,"New Castle County, Delaware",NA,2023,573030,32032,540998,5.589934209
10005,"Sussex County, Delaware",NA,2023,247799,11301,236498,4.560551092
11001,"District of Columbia, District of Columbia",NA,2023,672079,45075,627004,6.706800837
12001,"Alachua County, Florida",NA,2023,281751,14611,267140,5.185784611
12003,"Baker County, Florida",NA,2023,28186,225,27961,0.798268644
12005,"Bay County, Florida",NA,2023,181368,7302,174066,4.026068546
12007,"Bradford County, Florida",NA,2023,27888,96,27792,0.344234079
12009,"Brevard County, Florida",NA,2023,620533,18574,601959,2.993233237
12011,"Broward County, Florida",NA,2023,1946127,268395,1677732,13.79123767
12013,"Calhoun County, Florida",NA,2023,13593,277,13316,2.037813581
12015,"Charlotte County, Florida",NA,2023,195083,6764,188319,3.467242148
12017,"Citrus County, Florida",NA,2023,158693,2329,156364,1.467613568
12019,"Clay County, Florida",NA,2023,223436,4418,219018,1.977299987
12021,"Collier County, Florida",NA,2023,387681,45711,341970,11.79087961
12023,"Columbia County, Florida",NA,2023,70755,1464,69291,2.069111724
12027,"DeSoto County, Florida",NA,2023,34719,2794,31925,8.047466805
12029,"Dixie County, Florida",NA,2023,16952,242,16710,1.42756017
12031,"Duval County, Florida",NA,2023,1007189,51119,956070,5.075412857
12033,"Escambia County, Florida",NA,2023,323275,8942,314333,2.766066043
12035,"Flagler County, Florida",NA,2023,121710,4373,117337,3.592966889
12037,"Franklin County, Florida",NA,2023,12418,306,12112,2.464164922
12039,"Gadsden County, Florida",NA,2023,43642,1532,42110,3.510379909
12041,"Gilchrist County, Florida",NA,2023,18494,579,17915,3.130745107
12043,"Glades County, Florida",NA,2023,12324,777,11547,6.304771178
12045,"Gulf County, Florida",NA,2023,14772,277,14495,1.875169239
12047,"Hamilton County, Florida",NA,2023,13445,259,13186,1.926366679
12049,"Hardee County, Florida",NA,2023,25508,1692,23816,6.63321311
12051,"Hendry County, Florida",NA,2023,40798,6455,34343,15.82185401
12053,"Hernando County, Florida",NA,2023,201512,5056,196456,2.50903172
12055,"Highlands County, Florida",NA,2023,103808,4922,98886,4.741445746
12057,"Hillsborough County, Florida",NA,2023,1489634,133145,1356489,8.938101574
12059,"Holmes County, Florida",NA,2023,19626,97,19529,0.494242332
12061,"Indian River County, Florida",NA,2023,163856,6078,157778,3.709354555
12063,"Jackson County, Florida",NA,2023,47652,429,47223,0.900277008
12065,"Jefferson County, Florida",NA,2023,14713,158,14555,1.073880242
12067,"Lafayette County, Florida",NA,2023,8035,214,7821,2.663347853
12069,"Lake County, Florida",NA,2023,398696,16242,382454,4.073780525
12071,"Lee County, Florida",NA,2023,792692,69638,723054,8.785000984
12073,"Leon County, Florida",NA,2023,295335,9673,285662,3.275263684
12075,"Levy County, Florida",NA,2023,44276,1235,43041,2.789321529
12077,"Liberty County, Florida",NA,2023,7650,117,7533,1.529411765
12079,"Madison County, Florida",NA,2023,18113,351,17762,1.937834704
12081,"Manatee County, Florida",NA,2023,416020,26719,389301,6.422527763
12083,"Marion County, Florida",NA,2023,387697,13145,374552,3.390534361
12085,"Martin County, Florida",NA,2023,160464,7814,152650,4.869628079
12086,"Miami-Dade County, Florida",NA,2023,2685296,579183,2106113,21.56868368
12087,"Monroe County, Florida",NA,2023,81840,6520,75320,7.966764418
12089,"Nassau County, Florida",NA,2023,94653,1208,93445,1.276240584
12091,"Okaloosa County, Florida",NA,2023,214281,9124,205157,4.257960342
12093,"Okeechobee County, Florida",NA,2023,40249,2498,37751,6.206365376
12095,"Orange County, Florida",NA,2023,1440471,167460,1273011,11.6253642
12097,"Osceola County, Florida",NA,2023,406943,51273,355670,12.59955325
12099,"Palm Beach County, Florida",NA,2023,1507453,174620,1332833,11.5837774
12101,"Pasco County, Florida",NA,2023,588758,25702,563056,4.365460851
12103,"Pinellas County, Florida",NA,2023,960565,41113,919452,4.280085158
12105,"Polk County, Florida",NA,2023,760961,46652,714309,6.130668983
12107,"Putnam County, Florida",NA,2023,74235,2312,71923,3.114433892
12109,"St. Johns County, Florida",NA,2023,292243,9654,282589,3.303415308
12111,"St. Lucie County, Florida",NA,2023,346237,21551,324686,6.224349217
12113,"Santa Rosa County, Florida",NA,2023,193719,3118,190601,1.60954785
12115,"Sarasota County, Florida",NA,2023,449011,20246,428765,4.509020937
12117,"Seminole County, Florida",NA,2023,474912,27774,447138,5.848241358
12119,"Sumter County, Florida",NA,2023,137536,2873,134663,2.088907631
12121,"Suwannee County, Florida",NA,2023,44484,1242,43242,2.792015107
12123,"Taylor County, Florida",NA,2023,21422,685,20737,3.197647278
12125,"Union County, Florida",NA,2023,15551,209,15342,1.343965018
12127,"Volusia County, Florida",NA,2023,568229,18117,550112,3.188327241
12129,"Wakulla County, Florida",NA,2023,34608,608,34000,1.756819233
12131,"Walton County, Florida",NA,2023,79846,2632,77214,3.296345465
12133,"Washington County, Florida",NA,2023,25259,356,24903,1.40939863
13001,"Appling County, Georgia",NA,2023,18426,754,17672,4.092043851
13003,"Atkinson County, Georgia",NA,2023,8261,982,7279,11.88718073
13005,"Bacon County, Georgia",NA,2023,11129,281,10848,2.524934855
13007,"Baker County, Georgia",NA,2023,2830,65,2765,2.296819788
13009,"Baldwin County, Georgia",NA,2023,43669,455,43214,1.041929057
13011,"Banks County, Georgia",NA,2023,18757,561,18196,2.990883404
13013,"Barrow County, Georgia",NA,2023,86982,4141,82841,4.760755099
13015,"Bartow County, Georgia",NA,2023,111153,2648,108505,2.382301872
13017,"Ben Hill County, Georgia",NA,2023,17138,348,16790,2.03057533
13019,"Berrien County, Georgia",NA,2023,18257,140,18117,0.766829161
13021,"Bibb County, Georgia",NA,2023,156543,3169,153374,2.024363913
13023,"Bleckley County, Georgia",NA,2023,12414,78,12336,0.628322861
13025,"Brantley County, Georgia",NA,2023,18171,321,17850,1.766551098
13027,"Brooks County, Georgia",NA,2023,16285,149,16136,0.91495241
13029,"Bryan County, Georgia",NA,2023,46681,784,45897,1.679484158
13031,"Bulloch County, Georgia",NA,2023,81372,1664,79708,2.04492946
13033,"Burke County, Georgia",NA,2023,24427,250,24177,1.023457649
13035,"Butts County, Georgia",NA,2023,26074,231,25843,0.885940017
13037,"Calhoun County, Georgia",NA,2023,5528,114,5414,2.062228654
13039,"Camden County, Georgia",NA,2023,56036,333,55703,0.594260832
13043,"Candler County, Georgia",NA,2023,10972,672,10300,6.124681006
13045,"Carroll County, Georgia",NA,2023,122187,4748,117439,3.885847103
13047,"Catoosa County, Georgia",NA,2023,68356,544,67812,0.795833577
13049,"Charlton County, Georgia",NA,2023,12711,208,12503,1.63637794
13051,"Chatham County, Georgia",NA,2023,298143,11622,286521,3.898129421
13053,"Chattahoochee County, Georgia",NA,2023,9181,99,9082,1.078313909
13055,"Chattooga County, Georgia",NA,2023,24975,560,24415,2.242242242
13057,"Cherokee County, Georgia",NA,2023,274539,16144,258395,5.880403149
13059,"Clarke County, Georgia",NA,2023,129267,7963,121304,6.160118205
13061,"Clay County, Georgia",NA,2023,2853,0,2853,0
13063,"Clayton County, Georgia",NA,2023,298771,20433,278338,6.839017174
13065,"Clinch County, Georgia",NA,2023,6722,340,6382,5.058018447
13067,"Cobb County, Georgia",NA,2023,769152,66811,702341,8.686319479
13069,"Coffee County, Georgia",NA,2023,43161,2303,40858,5.335835592
13071,"Colquitt County, Georgia",NA,2023,45907,3997,41910,8.706733178
13073,"Columbia County, Georgia",NA,2023,159638,4327,155311,2.710507523
13075,"Cook County, Georgia",NA,2023,17363,282,17081,1.624143293
13077,"Coweta County, Georgia",NA,2023,150071,5196,144875,3.462361149
13079,"Crawford County, Georgia",NA,2023,12183,59,12124,0.484281376
13081,"Crisp County, Georgia",NA,2023,19995,91,19904,0.455113778
13083,"Dade County, Georgia",NA,2023,16196,98,16098,0.605087676
13085,"Dawson County, Georgia",NA,2023,28704,639,28065,2.226170569
13087,"Decatur County, Georgia",NA,2023,29118,775,28343,2.6615839
13089,"DeKalb County, Georgia",NA,2023,762105,66822,695283,8.768083138
13091,"Dodge County, Georgia",NA,2023,19909,242,19667,1.215530665
13093,"Dooly County, Georgia",NA,2023,11026,372,10654,3.373843642
13095,"Dougherty County, Georgia",NA,2023,83915,1024,82891,1.220282429
13097,"Douglas County, Georgia",NA,2023,146141,6271,139870,4.291061372
13099,"Early County, Georgia",NA,2023,10683,109,10574,1.020312646
13101,"Echols County, Georgia",NA,2023,3705,300,3405,8.097165992
13103,"Effingham County, Georgia",NA,2023,67265,1228,66037,1.825615104
13105,"Elbert County, Georgia",NA,2023,19725,305,19420,1.54626109
13107,"Emanuel County, Georgia",NA,2023,22961,474,22487,2.064370019
13109,"Evans County, Georgia",NA,2023,10740,371,10369,3.454376164
13111,"Fannin County, Georgia",NA,2023,25605,278,25327,1.085725444
13113,"Fayette County, Georgia",NA,2023,120689,6256,114433,5.183570997
13115,"Floyd County, Georgia",NA,2023,98985,4281,94704,4.324897712
13117,"Forsyth County, Georgia",NA,2023,260062,29307,230755,11.2692358
13119,"Franklin County, Georgia",NA,2023,23840,854,22986,3.582214765
13121,"Fulton County, Georgia",NA,2023,1068507,71908,996599,6.729764054
13123,"Gilmer County, Georgia",NA,2023,31976,710,31266,2.220415311
13125,"Glascock County, Georgia",NA,2023,2913,0,2913,0
13127,"Glynn County, Georgia",NA,2023,84987,2479,82508,2.916916705
13129,"Gordon County, Georgia",NA,2023,58336,2913,55423,4.993486012
13131,"Grady County, Georgia",NA,2023,26056,1226,24830,4.70525023
13133,"Greene County, Georgia",NA,2023,19586,314,19272,1.603185949
13135,"Gwinnett County, Georgia",NA,2023,966972,132293,834679,13.6811614
13137,"Habersham County, Georgia",NA,2023,46948,2766,44182,5.891624776
13139,"Hall County, Georgia",NA,2023,208395,22933,185462,11.00458264
13141,"Hancock County, Georgia",NA,2023,8630,55,8575,0.637311703
13143,"Haralson County, Georgia",NA,2023,30720,128,30592,0.416666667
13145,"Harris County, Georgia",NA,2023,35509,204,35305,0.574502239
13147,"Hart County, Georgia",NA,2023,26484,319,26165,1.204500831
13149,"Heard County, Georgia",NA,2023,11616,41,11575,0.352961433
13151,"Henry County, Georgia",NA,2023,245417,6537,238880,2.663629659
13153,"Houston County, Georgia",NA,2023,166902,5250,161652,3.145558471
13155,"Irwin County, Georgia",NA,2023,9385,98,9287,1.044219499
13157,"Jackson County, Georgia",NA,2023,80640,1859,78781,2.30530754
13159,"Jasper County, Georgia",NA,2023,15345,279,15066,1.818181818
13161,"Jeff Davis County, Georgia",NA,2023,14838,653,14185,4.40086265
13163,"Jefferson County, Georgia",NA,2023,15468,305,15163,1.971812775
13165,"Jenkins County, Georgia",NA,2023,8674,85,8589,0.979940051
13167,"Johnson County, Georgia",NA,2023,9192,56,9136,0.609225413
13169,"Jones County, Georgia",NA,2023,28526,166,28360,0.581925261
13171,"Lamar County, Georgia",NA,2023,19098,140,18958,0.733061054
13173,"Lanier County, Georgia",NA,2023,10094,281,9813,2.783831979
13175,"Laurens County, Georgia",NA,2023,49619,826,48793,1.664684899
13177,"Lee County, Georgia",NA,2023,33337,534,32803,1.601823799
13179,"Liberty County, Georgia",NA,2023,66826,2070,64756,3.097596744
13181,"Lincoln County, Georgia",NA,2023,7773,151,7622,1.942621896
13183,"Long County, Georgia",NA,2023,17512,293,17219,1.673138419
13185,"Lowndes County, Georgia",NA,2023,119055,2124,116931,1.784049389
13187,"Lumpkin County, Georgia",NA,2023,33931,554,33377,1.632725237
13189,"McDuffie County, Georgia",NA,2023,21687,167,21520,0.770046572
13191,"McIntosh County, Georgia",NA,2023,11187,9,11178,0.080450523
13193,"Macon County, Georgia",NA,2023,11953,332,11621,2.777545386
13195,"Madison County, Georgia",NA,2023,30914,832,30082,2.691337258
13197,"Marion County, Georgia",NA,2023,7474,367,7107,4.9103559
13199,"Meriwether County, Georgia",NA,2023,20757,27,20730,0.130076601
13201,"Miller County, Georgia",NA,2023,5873,104,5769,1.770815597
13205,"Mitchell County, Georgia",NA,2023,21441,312,21129,1.45515601
13207,"Monroe County, Georgia",NA,2023,28919,158,28761,0.546353608
13209,"Montgomery County, Georgia",NA,2023,8675,171,8504,1.971181556
13211,"Morgan County, Georgia",NA,2023,20614,258,20356,1.251576598
13213,"Murray County, Georgia",NA,2023,40282,1482,38800,3.679062609
13215,"Muscogee County, Georgia",NA,2023,204383,4713,199670,2.305964782
13217,"Newton County, Georgia",NA,2023,115530,3941,111589,3.411235177
13219,"Oconee County, Georgia",NA,2023,42788,1204,41584,2.813873049
13221,"Oglethorpe County, Georgia",NA,2023,15221,318,14903,2.089218842
13223,"Paulding County, Georgia",NA,2023,174292,5765,168527,3.307667592
13225,"Peach County, Georgia",NA,2023,28269,798,27471,2.822880187
13227,"Pickens County, Georgia",NA,2023,34197,556,33641,1.625873615
13229,"Pierce County, Georgia",NA,2023,19996,284,19712,1.420284057
13231,"Pike County, Georgia",NA,2023,19540,126,19414,0.644831116
13233,"Polk County, Georgia",NA,2023,43365,2214,41151,5.105499827
13235,"Pulaski County, Georgia",NA,2023,9893,246,9647,2.486606692
13237,"Putnam County, Georgia",NA,2023,22524,596,21928,2.646066418
13239,"Quitman County, Georgia",NA,2023,2092,5,2087,0.239005736
13241,"Rabun County, Georgia",NA,2023,17107,629,16478,3.676857427
13243,"Randolph County, Georgia",NA,2023,6270,11,6259,0.175438596
13245,"Richmond County, Georgia",NA,2023,206040,3340,202700,1.621044457
13247,"Rockdale County, Georgia",NA,2023,94293,4342,89951,4.60479569
13249,"Schley County, Georgia",NA,2023,4539,4,4535,0.088125138
13251,"Screven County, Georgia",NA,2023,14057,31,14026,0.220530696
13253,"Seminole County, Georgia",NA,2023,9117,58,9059,0.63617418
13255,"Spalding County, Georgia",NA,2023,68215,1212,67003,1.776735322
13257,"Stephens County, Georgia",NA,2023,26842,403,26439,1.501378437
13259,"Stewart County, Georgia",NA,2023,4978,607,4371,12.19365207
13261,"Sumter County, Georgia",NA,2023,29174,641,28533,2.197161856
13263,"Talbot County, Georgia",NA,2023,5753,0,5753,0
13265,"Taliaferro County, Georgia",NA,2023,1740,38,1702,2.183908046
13267,"Tattnall County, Georgia",NA,2023,24215,932,23283,3.848854016
13269,"Taylor County, Georgia",NA,2023,7786,84,7702,1.078859491
13271,"Telfair County, Georgia",NA,2023,12174,486,11688,3.992114342
13273,"Terrell County, Georgia",NA,2023,8941,56,8885,0.626328151
13275,"Thomas County, Georgia",NA,2023,45696,453,45243,0.991334034
13277,"Tift County, Georgia",NA,2023,41322,1728,39594,4.181791782
13279,"Toombs County, Georgia",NA,2023,26943,1273,25670,4.72478937
13281,"Towns County, Georgia",NA,2023,12739,135,12604,1.059737813
13283,"Treutlen County, Georgia",NA,2023,6387,49,6338,0.767183341
13285,"Troup County, Georgia",NA,2023,69821,2107,67714,3.017716733
13287,"Turner County, Georgia",NA,2023,8915,149,8766,1.671340437
13289,"Twiggs County, Georgia",NA,2023,7869,51,7818,0.648112848
13291,"Union County, Georgia",NA,2023,25598,418,25180,1.632940073
13293,"Upson County, Georgia",NA,2023,27856,293,27563,1.051838024
13295,"Walker County, Georgia",NA,2023,68449,444,68005,0.648658125
13297,"Walton County, Georgia",NA,2023,100361,2137,98224,2.129313179
13299,"Ware County, Georgia",NA,2023,35958,705,35253,1.960620724
13301,"Warren County, Georgia",NA,2023,5175,6,5169,0.115942029
13303,"Washington County, Georgia",NA,2023,19893,189,19704,0.950082944
13305,"Wayne County, Georgia",NA,2023,30519,632,29887,2.070841115
13307,"Webster County, Georgia",NA,2023,2348,105,2243,4.471890971
13309,"Wheeler County, Georgia",NA,2023,7434,27,7407,0.363196126
13311,"White County, Georgia",NA,2023,28454,225,28229,0.790749982
13313,"Whitfield County, Georgia",NA,2023,103118,11422,91696,11.07663066
13315,"Wilcox County, Georgia",NA,2023,8784,201,8583,2.288251366
13317,"Wilkes County, Georgia",NA,2023,9553,207,9346,2.166858578
13319,"Wilkinson County, Georgia",NA,2023,8795,110,8685,1.250710631
13321,"Worth County, Georgia",NA,2023,20575,76,20499,0.369380316
15001,"Hawaii County, Hawaii",NA,2023,203684,12311,191373,6.044166454
15003,"Honolulu County, Hawaii",NA,2023,1003666,73359,930307,7.309104822
15005,"Kalawao County, Hawaii",NA,2023,43,2,41,4.651162791
15007,"Kauai County, Hawaii",NA,2023,73610,4949,68661,6.723271295
15009,"Maui County, Hawaii",NA,2023,164632,12594,152038,7.649788619
16001,"Ada County, Idaho",NA,2023,508052,13754,494298,2.7072032
16003,"Adams County, Idaho",NA,2023,4599,27,4572,0.587084149
16005,"Bannock County, Idaho",NA,2023,88457,1461,86996,1.651649954
16007,"Bear Lake County, Idaho",NA,2023,6552,74,6478,1.129426129
16009,"Benewah County, Idaho",NA,2023,9913,15,9898,0.151316453
16011,"Bingham County, Idaho",NA,2023,48993,1334,47659,2.722837956
16013,"Blaine County, Idaho",NA,2023,24579,2330,22249,9.479637089
16015,"Boise County, Idaho",NA,2023,8045,107,7938,1.330018645
16017,"Bonner County, Idaho",NA,2023,49456,668,48788,1.350695568
16019,"Bonneville County, Idaho",NA,2023,127056,2183,124873,1.718140033
16021,"Boundary County, Idaho",NA,2023,12695,446,12249,3.513194171
16023,"Butte County, Idaho",NA,2023,2654,68,2586,2.562170309
16025,"Camas County, Idaho",NA,2023,1155,5,1150,0.432900433
16027,"Canyon County, Idaho",NA,2023,242405,10903,231502,4.497844516
16029,"Caribou County, Idaho",NA,2023,7118,134,6984,1.882551278
16031,"Cassia County, Idaho",NA,2023,25165,1853,23312,7.36340155
16033,"Clark County, Idaho",NA,2023,776,123,653,15.85051546
16035,"Clearwater County, Idaho",NA,2023,8921,117,8804,1.311512162
16037,"Custer County, Idaho",NA,2023,4411,20,4391,0.453411925
16039,"Elmore County, Idaho",NA,2023,29046,1362,27684,4.689113819
16041,"Franklin County, Idaho",NA,2023,14715,195,14520,1.325178389
16043,"Fremont County, Idaho",NA,2023,13701,435,13266,3.174950734
16045,"Gem County, Idaho",NA,2023,19854,623,19231,3.137906719
16047,"Gooding County, Idaho",NA,2023,15740,1437,14303,9.129606099
16049,"Idaho County, Idaho",NA,2023,17120,146,16974,0.852803738
16051,"Jefferson County, Idaho",NA,2023,32234,860,31374,2.667990321
16053,"Jerome County, Idaho",NA,2023,24788,3630,21158,14.64418267
16055,"Kootenai County, Idaho",NA,2023,177736,1609,176127,0.90527524
16057,"Latah County, Idaho",NA,2023,40315,1045,39270,2.592087312
16059,"Lemhi County, Idaho",NA,2023,8166,38,8128,0.46534411
16061,"Lewis County, Idaho",NA,2023,3649,11,3638,0.301452453
16063,"Lincoln County, Idaho",NA,2023,5276,499,4777,9.457922669
16065,"Madison County, Idaho",NA,2023,53578,2107,51471,3.93258427
16067,"Minidoka County, Idaho",NA,2023,21922,1314,20608,5.993978652
16069,"Nez Perce County, Idaho",NA,2023,42477,270,42207,0.63563811
16071,"Oneida County, Idaho",NA,2023,4681,22,4659,0.469985046
16073,"Owyhee County, Idaho",NA,2023,12284,918,11366,7.473135786
16075,"Payette County, Idaho",NA,2023,26190,724,25466,2.764413898
16077,"Power County, Idaho",NA,2023,8018,635,7383,7.919680718
16079,"Shoshone County, Idaho",NA,2023,13580,97,13483,0.714285714
16081,"Teton County, Idaho",NA,2023,12101,916,11185,7.569622345
16083,"Twin Falls County, Idaho",NA,2023,92121,3727,88394,4.045765895
16085,"Valley County, Idaho",NA,2023,12136,73,12063,0.60151615
16087,"Washington County, Idaho",NA,2023,10866,411,10455,3.782440641
17001,"Adams County, Illinois",NA,2023,65166,299,64867,0.458828223
17003,"Alexander County, Illinois",NA,2023,5042,1,5041,0.019833399
17005,"Bond County, Illinois",NA,2023,16627,158,16469,0.950261623
17007,"Boone County, Illinois",NA,2023,53316,2644,50672,4.959111711
17009,"Brown County, Illinois",NA,2023,6320,31,6289,0.490506329
17011,"Bureau County, Illinois",NA,2023,33027,559,32468,1.692554577
17013,"Calhoun County, Illinois",NA,2023,4406,3,4403,0.06808897
17015,"Carroll County, Illinois",NA,2023,15621,69,15552,0.441713079
17017,"Cass County, Illinois",NA,2023,12826,1330,11496,10.36956183
17019,"Champaign County, Illinois",NA,2023,206098,18269,187829,8.864229638
17021,"Christian County, Illinois",NA,2023,33684,138,33546,0.409690061
17023,"Clark County, Illinois",NA,2023,15328,107,15221,0.698068894
17025,"Clay County, Illinois",NA,2023,13173,21,13152,0.159416989
17027,"Clinton County, Illinois",NA,2023,36899,580,36319,1.571858316
17029,"Coles County, Illinois",NA,2023,46689,584,46105,1.25082996
17031,"Cook County, Illinois",NA,2023,5185812,520056,4665756,10.02843913
17033,"Crawford County, Illinois",NA,2023,18588,74,18514,0.398106305
17035,"Cumberland County, Illinois",NA,2023,10378,20,10358,0.192715359
17037,"DeKalb County, Illinois",NA,2023,100512,3251,97261,3.234439669
17039,"De Witt County, Illinois",NA,2023,15461,113,15348,0.730871224
17041,"Douglas County, Illinois",NA,2023,19686,429,19257,2.179213654
17043,"DuPage County, Illinois",NA,2023,927263,77340,849923,8.340675731
17045,"Edgar County, Illinois",NA,2023,16637,54,16583,0.324577748
17047,"Edwards County, Illinois",NA,2023,6118,15,6103,0.245178163
17049,"Effingham County, Illinois",NA,2023,34505,436,34069,1.263584988
17051,"Fayette County, Illinois",NA,2023,21380,108,21272,0.505144995
17053,"Ford County, Illinois",NA,2023,13396,206,13190,1.537772469
17055,"Franklin County, Illinois",NA,2023,37541,213,37328,0.567379665
17057,"Fulton County, Illinois",NA,2023,33259,219,33040,0.658468384
17059,"Gallatin County, Illinois",NA,2023,4857,10,4847,0.205888408
17061,"Greene County, Illinois",NA,2023,11837,3,11834,0.02534426
17063,"Grundy County, Illinois",NA,2023,52920,642,52278,1.213151927
17065,"Hamilton County, Illinois",NA,2023,7972,17,7955,0.213246362
17067,"Hancock County, Illinois",NA,2023,17434,174,17260,0.998049788
17069,"Hardin County, Illinois",NA,2023,3623,11,3612,0.303615788
17071,"Henderson County, Illinois",NA,2023,6284,15,6269,0.238701464
17073,"Henry County, Illinois",NA,2023,48948,312,48636,0.63741113
17075,"Iroquois County, Illinois",NA,2023,26746,524,26222,1.959171465
17077,"Jackson County, Illinois",NA,2023,52706,1977,50729,3.750996092
17079,"Jasper County, Illinois",NA,2023,9233,50,9183,0.541535796
17081,"Jefferson County, Illinois",NA,2023,36808,249,36559,0.676483373
17083,"Jersey County, Illinois",NA,2023,21336,171,21165,0.801462317
17085,"Jo Daviess County, Illinois",NA,2023,21918,109,21809,0.497308149
17087,"Johnson County, Illinois",NA,2023,13350,59,13291,0.441947566
17089,"Kane County, Illinois",NA,2023,516097,44644,471453,8.65031186
17091,"Kankakee County, Illinois",NA,2023,106833,2944,103889,2.755702826
17093,"Kendall County, Illinois",NA,2023,135053,6867,128186,5.084670463
17095,"Knox County, Illinois",NA,2023,49294,1158,48136,2.349170284
17097,"Lake County, Illinois",NA,2023,711885,66746,645139,9.375952577
17099,"LaSalle County, Illinois",NA,2023,109049,2135,106914,1.957835468
17101,"Lawrence County, Illinois",NA,2023,15137,150,14987,0.990949329
17103,"Lee County, Illinois",NA,2023,34058,469,33589,1.377062658
17105,"Livingston County, Illinois",NA,2023,35659,262,35397,0.734737373
17107,"Logan County, Illinois",NA,2023,27870,186,27684,0.667384284
17109,"McDonough County, Illinois",NA,2023,27102,342,26760,1.261899491
17111,"McHenry County, Illinois",NA,2023,311366,13127,298239,4.215938799
17113,"McLean County, Illinois",NA,2023,170882,6781,164101,3.968235391
17115,"Macon County, Illinois",NA,2023,102591,1535,101056,1.496232613
17117,"Macoupin County, Illinois",NA,2023,44566,152,44414,0.341067181
17119,"Madison County, Illinois",NA,2023,264631,2132,262499,0.805650132
17121,"Marion County, Illinois",NA,2023,37294,262,37032,0.702525875
17123,"Marshall County, Illinois",NA,2023,11715,108,11607,0.921895006
17125,"Mason County, Illinois",NA,2023,12878,12,12866,0.093182171
17127,"Massac County, Illinois",NA,2023,13958,141,13817,1.010173377
17129,"Menard County, Illinois",NA,2023,12169,56,12113,0.460185718
17131,"Mercer County, Illinois",NA,2023,15619,44,15575,0.281708176
17133,"Monroe County, Illinois",NA,2023,34969,56,34913,0.16014184
17135,"Montgomery County, Illinois",NA,2023,28078,116,27962,0.413134839
17137,"Morgan County, Illinois",NA,2023,32621,114,32507,0.349468134
17139,"Moultrie County, Illinois",NA,2023,14469,36,14433,0.248807796
17141,"Ogle County, Illinois",NA,2023,51536,1339,50197,2.598183794
17143,"Peoria County, Illinois",NA,2023,179831,7395,172436,4.112194227
17145,"Perry County, Illinois",NA,2023,20810,149,20661,0.716001922
17147,"Piatt County, Illinois",NA,2023,16702,42,16660,0.25146689
17149,"Pike County, Illinois",NA,2023,14625,97,14528,0.663247863
17151,"Pope County, Illinois",NA,2023,3757,17,3740,0.452488688
17153,"Pulaski County, Illinois",NA,2023,5074,6,5068,0.118249901
17155,"Putnam County, Illinois",NA,2023,5600,17,5583,0.303571429
17157,"Randolph County, Illinois",NA,2023,30142,553,29589,1.834649327
17159,"Richland County, Illinois",NA,2023,15675,97,15578,0.618819777
17161,"Rock Island County, Illinois",NA,2023,142995,6548,136447,4.57918109
17163,"St. Clair County, Illinois",NA,2023,254777,3531,251246,1.385917881
17165,"Saline County, Illinois",NA,2023,23387,160,23227,0.684140762
17167,"Sangamon County, Illinois",NA,2023,195217,3157,192060,1.617174734
17169,"Schuyler County, Illinois",NA,2023,6826,51,6775,0.747143276
17171,"Scott County, Illinois",NA,2023,4847,13,4834,0.268207138
17173,"Shelby County, Illinois",NA,2023,20867,86,20781,0.412133991
17175,"Stark County, Illinois",NA,2023,5324,57,5267,1.070623591
17177,"Stephenson County, Illinois",NA,2023,44042,515,43527,1.169338359
17179,"Tazewell County, Illinois",NA,2023,130555,833,129722,0.638045268
17181,"Union County, Illinois",NA,2023,16972,215,16757,1.266792364
17183,"Vermilion County, Illinois",NA,2023,73179,447,72732,0.610830976
17185,"Wabash County, Illinois",NA,2023,11199,94,11105,0.839360657
17187,"Warren County, Illinois",NA,2023,16576,419,16157,2.527750965
17189,"Washington County, Illinois",NA,2023,13682,43,13639,0.314281538
17191,"Wayne County, Illinois",NA,2023,15994,223,15771,1.394272852
17193,"White County, Illinois",NA,2023,13708,44,13664,0.320980449
17195,"Whiteside County, Illinois",NA,2023,55192,771,54421,1.396941586
17197,"Will County, Illinois",NA,2023,698450,39003,659447,5.584222206
17199,"Williamson County, Illinois",NA,2023,66902,778,66124,1.162894981
17201,"Winnebago County, Illinois",NA,2023,283289,12808,270481,4.52117802
17203,"Woodford County, Illinois",NA,2023,38348,307,38041,0.800563263
18001,"Adams County, Indiana",NA,2023,35995,287,35708,0.797332963
18003,"Allen County, Indiana",NA,2023,388791,15549,373242,3.999320972
18005,"Bartholomew County, Indiana",NA,2023,82881,6454,76427,7.787068206
18007,"Benton County, Indiana",NA,2023,8708,170,8538,1.952227836
18009,"Blackford County, Indiana",NA,2023,12007,68,11939,0.566336304
18011,"Boone County, Indiana",NA,2023,72827,1482,71345,2.034959562
18013,"Brown County, Indiana",NA,2023,15543,122,15421,0.784919256
18015,"Carroll County, Indiana",NA,2023,20443,185,20258,0.904955241
18017,"Cass County, Indiana",NA,2023,37703,2312,35391,6.132138026
18019,"Clark County, Indiana",NA,2023,122800,2862,119938,2.330618893
18021,"Clay County, Indiana",NA,2023,26431,25,26406,0.094585903
18023,"Clinton County, Indiana",NA,2023,32967,2188,30779,6.63693997
18025,"Crawford County, Indiana",NA,2023,10494,4,10490,0.038117019
18027,"Daviess County, Indiana",NA,2023,33442,941,32501,2.813826924
18029,"Dearborn County, Indiana",NA,2023,50828,267,50561,0.525301015
18031,"Decatur County, Indiana",NA,2023,26411,148,26263,0.560372572
18033,"DeKalb County, Indiana",NA,2023,43584,269,43315,0.617198972
18035,"Delaware County, Indiana",NA,2023,112109,1442,110667,1.286248205
18037,"Dubois County, Indiana",NA,2023,43563,1544,42019,3.544292175
18039,"Elkhart County, Indiana",NA,2023,206868,11256,195612,5.441150879
18041,"Fayette County, Indiana",NA,2023,23390,123,23267,0.525865755
18043,"Floyd County, Indiana",NA,2023,80512,1320,79192,1.639507154
18045,"Fountain County, Indiana",NA,2023,16546,92,16454,0.556025626
18047,"Franklin County, Indiana",NA,2023,22929,91,22838,0.396877317
18049,"Fulton County, Indiana",NA,2023,20411,238,20173,1.166037921
18051,"Gibson County, Indiana",NA,2023,32986,326,32660,0.988298066
18053,"Grant County, Indiana",NA,2023,66377,1052,65325,1.584886331
18055,"Greene County, Indiana",NA,2023,30954,137,30817,0.442592234
18057,"Hamilton County, Indiana",NA,2023,357176,16516,340660,4.624050888
18059,"Hancock County, Indiana",NA,2023,82013,803,81210,0.979113067
18061,"Harrison County, Indiana",NA,2023,39785,327,39458,0.821917808
18063,"Hendricks County, Indiana",NA,2023,179379,4092,175287,2.281203485
18065,"Henry County, Indiana",NA,2023,48896,263,48633,0.537876309
18067,"Howard County, Indiana",NA,2023,83610,572,83038,0.684128693
18069,"Huntington County, Indiana",NA,2023,36757,381,36376,1.036537258
18071,"Jackson County, Indiana",NA,2023,46319,3266,43053,7.05110214
18073,"Jasper County, Indiana",NA,2023,33198,590,32608,1.777215495
18075,"Jay County, Indiana",NA,2023,20281,124,20157,0.611409694
18077,"Jefferson County, Indiana",NA,2023,33074,304,32770,0.919150995
18079,"Jennings County, Indiana",NA,2023,27584,139,27445,0.503915313
18081,"Johnson County, Indiana",NA,2023,163983,4211,159772,2.567949117
18083,"Knox County, Indiana",NA,2023,36108,591,35517,1.636756397
18085,"Kosciusko County, Indiana",NA,2023,80357,2746,77611,3.41725052
18087,"LaGrange County, Indiana",NA,2023,40596,396,40200,0.975465563
18089,"Lake County, Indiana",NA,2023,498990,15598,483392,3.125914347
18091,"LaPorte County, Indiana",NA,2023,112141,1887,110254,1.682703026
18093,"Lawrence County, Indiana",NA,2023,45077,161,44916,0.357166626
18095,"Madison County, Indiana",NA,2023,130949,1155,129794,0.882022772
18097,"Marion County, Indiana",NA,2023,971822,74212,897610,7.636377855
18099,"Marshall County, Indiana",NA,2023,46225,1579,44646,3.415900487
18101,"Martin County, Indiana",NA,2023,9854,46,9808,0.466815506
18103,"Miami County, Indiana",NA,2023,35772,346,35426,0.967236945
18105,"Monroe County, Indiana",NA,2023,139822,7427,132395,5.311753515
18107,"Montgomery County, Indiana",NA,2023,38155,747,37408,1.957803695
18109,"Morgan County, Indiana",NA,2023,72202,450,71752,0.623251433
18111,"Newton County, Indiana",NA,2023,13859,313,13546,2.258460206
18113,"Noble County, Indiana",NA,2023,47417,1611,45806,3.397515659
18115,"Ohio County, Indiana",NA,2023,5993,27,5966,0.450525613
18117,"Orange County, Indiana",NA,2023,19746,62,19684,0.313987643
18119,"Owen County, Indiana",NA,2023,21434,69,21365,0.321918447
18121,"Parke County, Indiana",NA,2023,16346,48,16298,0.293649823
18123,"Perry County, Indiana",NA,2023,19218,87,19131,0.452700593
18125,"Pike County, Indiana",NA,2023,12187,8,12179,0.065643719
18127,"Porter County, Indiana",NA,2023,174150,2460,171690,1.412575366
18129,"Posey County, Indiana",NA,2023,25163,52,25111,0.206652625
18131,"Pulaski County, Indiana",NA,2023,12441,188,12253,1.511132546
18133,"Putnam County, Indiana",NA,2023,37091,600,36491,1.617643094
18135,"Randolph County, Indiana",NA,2023,24425,314,24111,1.285568066
18137,"Ripley County, Indiana",NA,2023,29039,97,28942,0.334033541
18139,"Rush County, Indiana",NA,2023,16734,106,16628,0.633440899
18141,"St. Joseph County, Indiana",NA,2023,272574,11407,261167,4.184918591
18143,"Scott County, Indiana",NA,2023,24468,140,24328,0.572175903
18145,"Shelby County, Indiana",NA,2023,45104,972,44132,2.15501951
18147,"Spencer County, Indiana",NA,2023,19871,288,19583,1.449348297
18149,"Starke County, Indiana",NA,2023,23300,241,23059,1.034334764
18151,"Steuben County, Indiana",NA,2023,34648,351,34297,1.013045486
18153,"Sullivan County, Indiana",NA,2023,20766,68,20698,0.327458345
18155,"Switzerland County, Indiana",NA,2023,9914,83,9831,0.837199919
18157,"Tippecanoe County, Indiana",NA,2023,187399,15809,171590,8.436010865
18159,"Tipton County, Indiana",NA,2023,15329,96,15233,0.626263944
18161,"Union County, Indiana",NA,2023,7028,21,7007,0.298804781
18163,"Vanderburgh County, Indiana",NA,2023,179908,3683,176225,2.047157436
18165,"Vermillion County, Indiana",NA,2023,15452,53,15399,0.34299767
18167,"Vigo County, Indiana",NA,2023,106201,1774,104427,1.670417416
18169,"Wabash County, Indiana",NA,2023,30901,141,30760,0.456295913
18171,"Warren County, Indiana",NA,2023,8469,32,8437,0.377848624
18173,"Warrick County, Indiana",NA,2023,64650,1071,63579,1.656612529
18175,"Washington County, Indiana",NA,2023,28167,80,28087,0.284020307
18177,"Wayne County, Indiana",NA,2023,66377,1395,64982,2.101631589
18179,"Wells County, Indiana",NA,2023,28261,178,28083,0.629843247
18181,"White County, Indiana",NA,2023,24709,998,23711,4.039014124
18183,"Whitley County, Indiana",NA,2023,34388,67,34321,0.194835408
19001,"Adair County, Iowa",NA,2023,7471,47,7424,0.629099184
19003,"Adams County, Iowa",NA,2023,3641,3,3638,0.082394946
19005,"Allamakee County, Iowa",NA,2023,14038,554,13484,3.946431116
19007,"Appanoose County, Iowa",NA,2023,12242,95,12147,0.776016991
19009,"Audubon County, Iowa",NA,2023,5622,30,5592,0.53361793
19011,"Benton County, Iowa",NA,2023,25698,62,25636,0.241263912
19013,"Black Hawk County, Iowa",NA,2023,130693,4354,126339,3.331471464
19015,"Boone County, Iowa",NA,2023,26669,52,26617,0.194982939
19017,"Bremer County, Iowa",NA,2023,25118,103,25015,0.410064496
19019,"Buchanan County, Iowa",NA,2023,20645,229,20416,1.109227416
19021,"Buena Vista County, Iowa",NA,2023,20684,2795,17889,13.51286018
19023,"Butler County, Iowa",NA,2023,14301,151,14150,1.055870219
19025,"Calhoun County, Iowa",NA,2023,9858,47,9811,0.476770136
19027,"Carroll County, Iowa",NA,2023,20677,153,20524,0.739952604
19029,"Cass County, Iowa",NA,2023,13115,32,13083,0.243995425
19031,"Cedar County, Iowa",NA,2023,18427,170,18257,0.922559288
19033,"Cerro Gordo County, Iowa",NA,2023,42785,496,42289,1.159284796
19035,"Cherokee County, Iowa",NA,2023,11587,234,11353,2.019504617
19037,"Chickasaw County, Iowa",NA,2023,11868,217,11651,1.828446242
19039,"Clarke County, Iowa",NA,2023,9690,199,9491,2.053663571
19041,"Clay County, Iowa",NA,2023,16446,103,16343,0.626292108
19043,"Clayton County, Iowa",NA,2023,17069,157,16912,0.919796122
19045,"Clinton County, Iowa",NA,2023,46383,355,46028,0.765366621
19047,"Crawford County, Iowa",NA,2023,16289,1189,15100,7.299404506
19049,"Dallas County, Iowa",NA,2023,104136,5134,99002,4.930091419
19051,"Davis County, Iowa",NA,2023,9127,88,9039,0.964172236
19053,"Decatur County, Iowa",NA,2023,7669,118,7551,1.538662146
19055,"Delaware County, Iowa",NA,2023,17549,21,17528,0.119664938
19057,"Des Moines County, Iowa",NA,2023,38597,631,37966,1.634842086
19059,"Dickinson County, Iowa",NA,2023,17844,256,17588,1.434655907
19061,"Dubuque County, Iowa",NA,2023,98948,2074,96874,2.096050451
19063,"Emmet County, Iowa",NA,2023,9316,205,9111,2.200515243
19065,"Fayette County, Iowa",NA,2023,19393,249,19144,1.283968442
19067,"Floyd County, Iowa",NA,2023,15502,68,15434,0.438653077
19069,"Franklin County, Iowa",NA,2023,9977,549,9428,5.502656109
19071,"Fremont County, Iowa",NA,2023,6570,62,6508,0.943683409
19073,"Greene County, Iowa",NA,2023,8722,75,8647,0.85989452
19075,"Grundy County, Iowa",NA,2023,12352,85,12267,0.688147668
19077,"Guthrie County, Iowa",NA,2023,10646,147,10499,1.380800301
19079,"Hamilton County, Iowa",NA,2023,14893,746,14147,5.009064661
19081,"Hancock County, Iowa",NA,2023,10718,148,10570,1.380854637
19083,"Hardin County, Iowa",NA,2023,16729,340,16389,2.032398828
19085,"Harrison County, Iowa",NA,2023,14645,47,14598,0.320928645
19087,"Henry County, Iowa",NA,2023,20228,303,19925,1.49792367
19089,"Howard County, Iowa",NA,2023,9459,88,9371,0.930330902
19091,"Humboldt County, Iowa",NA,2023,9573,289,9284,3.018907344
19093,"Ida County, Iowa",NA,2023,6944,72,6872,1.036866359
19095,"Iowa County, Iowa",NA,2023,16547,83,16464,0.501601499
19097,"Jackson County, Iowa",NA,2023,19429,51,19378,0.26249421
19099,"Jasper County, Iowa",NA,2023,37864,719,37145,1.898901331
19101,"Jefferson County, Iowa",NA,2023,15676,1361,14315,8.68206175
19103,"Johnson County, Iowa",NA,2023,154881,9115,145766,5.885163448
19105,"Jones County, Iowa",NA,2023,20799,99,20700,0.475984422
19107,"Keokuk County, Iowa",NA,2023,9964,58,9906,0.582095544
19109,"Kossuth County, Iowa",NA,2023,14610,340,14270,2.327173169
19111,"Lee County, Iowa",NA,2023,33175,52,33123,0.156744537
19113,"Linn County, Iowa",NA,2023,229463,5492,223971,2.393414189
19115,"Louisa County, Iowa",NA,2023,10710,530,10180,4.948646125
19117,"Lucas County, Iowa",NA,2023,8685,95,8590,1.093839954
19119,"Lyon County, Iowa",NA,2023,12087,114,11973,0.943162075
19121,"Madison County, Iowa",NA,2023,16760,63,16697,0.375894988
19123,"Mahaska County, Iowa",NA,2023,22045,245,21800,1.111363121
19125,"Marion County, Iowa",NA,2023,33551,291,33260,0.867336294
19127,"Marshall County, Iowa",NA,2023,39971,3485,36486,8.718821145
19129,"Mills County, Iowa",NA,2023,14563,87,14476,0.597404381
19131,"Mitchell County, Iowa",NA,2023,10548,110,10438,1.042851725
19133,"Monona County, Iowa",NA,2023,8619,6,8613,0.069613644
19135,"Monroe County, Iowa",NA,2023,7546,0,7546,0
19137,"Montgomery County, Iowa",NA,2023,10254,71,10183,0.692412717
19139,"Muscatine County, Iowa",NA,2023,42735,1717,41018,4.017784018
19141,"O'Brien County, Iowa",NA,2023,14103,377,13726,2.673190101
19143,"Osceola County, Iowa",NA,2023,6114,188,5926,3.074910043
19145,"Page County, Iowa",NA,2023,15168,81,15087,0.534018987
19147,"Palo Alto County, Iowa",NA,2023,8902,85,8817,0.954841609
19149,"Plymouth County, Iowa",NA,2023,25699,645,25054,2.509825285
19151,"Pocahontas County, Iowa",NA,2023,7040,147,6893,2.088068182
19153,"Polk County, Iowa",NA,2023,497441,26377,471064,5.302538391
19155,"Pottawattamie County, Iowa",NA,2023,93407,1865,91542,1.996638368
19157,"Poweshiek County, Iowa",NA,2023,18582,457,18125,2.459369282
19159,"Ringgold County, Iowa",NA,2023,4664,19,4645,0.407375643
19161,"Sac County, Iowa",NA,2023,9759,185,9574,1.895686033
19163,"Scott County, Iowa",NA,2023,174302,3261,171041,1.870890753
19165,"Shelby County, Iowa",NA,2023,11757,108,11649,0.918601684
19167,"Sioux County, Iowa",NA,2023,35984,1650,34334,4.585371276
19169,"Story County, Iowa",NA,2023,98592,5216,93376,5.290490101
19171,"Tama County, Iowa",NA,2023,16982,502,16480,2.956071134
19173,"Taylor County, Iowa",NA,2023,5901,138,5763,2.33858668
19175,"Union County, Iowa",NA,2023,12038,72,11966,0.598105998
19177,"Van Buren County, Iowa",NA,2023,7236,33,7203,0.456053068
19179,"Wapello County, Iowa",NA,2023,35265,1897,33368,5.379271232
19181,"Warren County, Iowa",NA,2023,53484,304,53180,0.568394286
19183,"Washington County, Iowa",NA,2023,22539,546,21993,2.422467723
19185,"Wayne County, Iowa",NA,2023,6518,44,6474,0.675053697
19187,"Webster County, Iowa",NA,2023,36848,983,35865,2.667716023
19189,"Winnebago County, Iowa",NA,2023,10648,158,10490,1.483846732
19191,"Winneshiek County, Iowa",NA,2023,19972,322,19650,1.61225716
19193,"Woodbury County, Iowa",NA,2023,105760,6194,99566,5.856656581
19195,"Worth County, Iowa",NA,2023,7380,38,7342,0.514905149
19197,"Wright County, Iowa",NA,2023,12817,647,12170,5.047983147
20001,"Allen County, Kansas",NA,2023,12491,231,12260,1.849331519
20003,"Anderson County, Kansas",NA,2023,7819,7,7812,0.089525515
20005,"Atchison County, Kansas",NA,2023,16211,115,16096,0.709394855
20007,"Barber County, Kansas",NA,2023,4153,24,4129,0.577895497
20009,"Barton County, Kansas",NA,2023,25275,548,24727,2.168150346
20011,"Bourbon County, Kansas",NA,2023,14384,162,14222,1.12625139
20013,"Brown County, Kansas",NA,2023,9415,66,9349,0.701009028
20015,"Butler County, Kansas",NA,2023,67916,1410,66506,2.076093998
20017,"Chase County, Kansas",NA,2023,2579,98,2481,3.799922451
20019,"Chautauqua County, Kansas",NA,2023,3370,17,3353,0.504451039
20021,"Cherokee County, Kansas",NA,2023,19236,98,19138,0.509461426
20023,"Cheyenne County, Kansas",NA,2023,2628,105,2523,3.99543379
20025,"Clark County, Kansas",NA,2023,1987,28,1959,1.409159537
20027,"Clay County, Kansas",NA,2023,8071,46,8025,0.569941767
20029,"Cloud County, Kansas",NA,2023,8973,179,8794,1.994873509
20031,"Coffey County, Kansas",NA,2023,8304,20,8284,0.240847784
20033,"Comanche County, Kansas",NA,2023,1685,1,1684,0.059347181
20035,"Cowley County, Kansas",NA,2023,34487,829,33658,2.403804332
20037,"Crawford County, Kansas",NA,2023,38963,809,38154,2.076328825
20039,"Decatur County, Kansas",NA,2023,2746,43,2703,1.565914057
20041,"Dickinson County, Kansas",NA,2023,18423,56,18367,0.303967866
20043,"Doniphan County, Kansas",NA,2023,7492,82,7410,1.094500801
20045,"Douglas County, Kansas",NA,2023,119547,4797,114750,4.012647745
20047,"Edwards County, Kansas",NA,2023,2817,213,2604,7.561235357
20049,"Elk County, Kansas",NA,2023,2464,7,2457,0.284090909
20051,"Ellis County, Kansas",NA,2023,28870,507,28363,1.756148251
20053,"Ellsworth County, Kansas",NA,2023,6366,62,6304,0.973923971
20055,"Finney County, Kansas",NA,2023,38001,5040,32961,13.26280887
20057,"Ford County, Kansas",NA,2023,34133,5052,29081,14.80092579
20059,"Franklin County, Kansas",NA,2023,25994,251,25743,0.965607448
20061,"Geary County, Kansas",NA,2023,35895,1078,34817,3.003203789
20063,"Gove County, Kansas",NA,2023,2796,4,2792,0.143061516
20065,"Graham County, Kansas",NA,2023,2406,5,2401,0.207813799
20067,"Grant County, Kansas",NA,2023,7284,1053,6231,14.45634267
20069,"Gray County, Kansas",NA,2023,5696,525,5171,9.216994382
20071,"Greeley County, Kansas",NA,2023,1296,63,1233,4.861111111
20073,"Greenwood County, Kansas",NA,2023,5956,23,5933,0.386165212
20075,"Hamilton County, Kansas",NA,2023,2485,475,2010,19.11468813
20077,"Harper County, Kansas",NA,2023,5446,98,5348,1.799485861
20079,"Harvey County, Kansas",NA,2023,33823,419,33404,1.238801999
20081,"Haskell County, Kansas",NA,2023,3695,600,3095,16.23815968
20083,"Hodgeman County, Kansas",NA,2023,1676,14,1662,0.835322196
20085,"Jackson County, Kansas",NA,2023,13277,321,12956,2.417714845
20087,"Jefferson County, Kansas",NA,2023,18391,65,18326,0.353433745
20089,"Jewell County, Kansas",NA,2023,2909,26,2883,0.893777931
20091,"Johnson County, Kansas",NA,2023,614764,26769,587995,4.354353866
20093,"Kearny County, Kansas",NA,2023,3910,354,3556,9.05370844
20095,"Kingman County, Kansas",NA,2023,7284,22,7262,0.302031851
20097,"Kiowa County, Kansas",NA,2023,2422,70,2352,2.89017341
20099,"Labette County, Kansas",NA,2023,19949,89,19860,0.446137651
20101,"Lane County, Kansas",NA,2023,1497,53,1444,3.540414162
20103,"Leavenworth County, Kansas",NA,2023,82493,1393,81100,1.688628126
20105,"Lincoln County, Kansas",NA,2023,2924,7,2917,0.239398085
20107,"Linn County, Kansas",NA,2023,9723,29,9694,0.298261853
20109,"Logan County, Kansas",NA,2023,2720,43,2677,1.580882353
20111,"Lyon County, Kansas",NA,2023,32145,2122,30023,6.601337689
20113,"McPherson County, Kansas",NA,2023,30130,566,29564,1.878526386
20115,"Marion County, Kansas",NA,2023,11795,52,11743,0.440864773
20117,"Marshall County, Kansas",NA,2023,10001,31,9970,0.309969003
20119,"Meade County, Kansas",NA,2023,3949,282,3667,7.141048367
20121,"Miami County, Kansas",NA,2023,34625,163,34462,0.470758123
20123,"Mitchell County, Kansas",NA,2023,5767,17,5750,0.294780649
20125,"Montgomery County, Kansas",NA,2023,31143,594,30549,1.9073307
20127,"Morris County, Kansas",NA,2023,5388,43,5345,0.798069785
20129,"Morton County, Kansas",NA,2023,2647,157,2490,5.931242917
20131,"Nemaha County, Kansas",NA,2023,10213,63,10150,0.616860864
20133,"Neosho County, Kansas",NA,2023,15715,159,15556,1.011772192
20135,"Ness County, Kansas",NA,2023,2659,173,2486,6.50620534
20137,"Norton County, Kansas",NA,2023,5392,60,5332,1.112759644
20139,"Osage County, Kansas",NA,2023,15780,60,15720,0.380228137
20141,"Osborne County, Kansas",NA,2023,3473,28,3445,0.806219407
20143,"Ottawa County, Kansas",NA,2023,5782,45,5737,0.778277413
20145,"Pawnee County, Kansas",NA,2023,6220,12,6208,0.192926045
20147,"Phillips County, Kansas",NA,2023,4874,28,4846,0.574476816
20149,"Pottawatomie County, Kansas",NA,2023,25808,304,25504,1.177929324
20151,"Pratt County, Kansas",NA,2023,9120,13,9107,0.14254386
20153,"Rawlins County, Kansas",NA,2023,2533,35,2498,1.381760758
20155,"Reno County, Kansas",NA,2023,61693,822,60871,1.332404
20157,"Republic County, Kansas",NA,2023,4662,26,4636,0.557700558
20159,"Rice County, Kansas",NA,2023,9389,119,9270,1.267440622
20161,"Riley County, Kansas",NA,2023,71710,3094,68616,4.314600474
20163,"Rooks County, Kansas",NA,2023,4869,3,4866,0.061614295
20165,"Rush County, Kansas",NA,2023,2957,36,2921,1.217450118
20167,"Russell County, Kansas",NA,2023,6717,102,6615,1.51853506
20169,"Saline County, Kansas",NA,2023,53801,1284,52517,2.38657274
20171,"Scott County, Kansas",NA,2023,5071,366,4705,7.217511339
20173,"Sedgwick County, Kansas",NA,2023,524810,23875,500935,4.549265448
20175,"Seward County, Kansas",NA,2023,21640,3886,17754,17.95748614
20177,"Shawnee County, Kansas",NA,2023,178315,4519,173796,2.534279225
20179,"Sheridan County, Kansas",NA,2023,2442,60,2382,2.457002457
20181,"Sherman County, Kansas",NA,2023,5919,150,5769,2.53421186
20183,"Smith County, Kansas",NA,2023,3579,26,3553,0.726459905
20185,"Stafford County, Kansas",NA,2023,4004,166,3838,4.145854146
20187,"Stanton County, Kansas",NA,2023,2018,371,1647,18.38453915
20189,"Stevens County, Kansas",NA,2023,5212,571,4641,10.95548734
20191,"Sumner County, Kansas",NA,2023,22386,142,22244,0.634325025
20193,"Thomas County, Kansas",NA,2023,7913,279,7634,3.525843549
20195,"Trego County, Kansas",NA,2023,2778,13,2765,0.467962563
20197,"Wabaunsee County, Kansas",NA,2023,6961,18,6943,0.258583537
20199,"Wallace County, Kansas",NA,2023,1459,20,1439,1.370801919
20201,"Washington County, Kansas",NA,2023,5519,120,5399,2.17430694
20203,"Wichita County, Kansas",NA,2023,2115,135,1980,6.382978723
20205,"Wilson County, Kansas",NA,2023,8559,66,8493,0.771118121
20207,"Woodson County, Kansas",NA,2023,3118,1,3117,0.032071841
20209,"Wyandotte County, Kansas",NA,2023,167277,21276,146001,12.71902294
21001,"Adair County, Kentucky",NA,2023,19016,506,18510,2.660917122
21003,"Allen County, Kentucky",NA,2023,21029,248,20781,1.179323791
21005,"Anderson County, Kentucky",NA,2023,24098,155,23943,0.643206905
21007,"Ballard County, Kentucky",NA,2023,7678,47,7631,0.612138578
21009,"Barren County, Kentucky",NA,2023,44670,628,44042,1.405865234
21011,"Bath County, Kentucky",NA,2023,12812,9,12803,0.070246644
21013,"Bell County, Kentucky",NA,2023,23878,25,23853,0.104698886
21015,"Boone County, Kentucky",NA,2023,137676,4979,132697,3.616461838
21017,"Bourbon County, Kentucky",NA,2023,20174,627,19547,3.107960742
21019,"Boyd County, Kentucky",NA,2023,48043,286,47757,0.595300044
21021,"Boyle County, Kentucky",NA,2023,30708,463,30245,1.507750423
21023,"Bracken County, Kentucky",NA,2023,8427,30,8397,0.355998576
21025,"Breathitt County, Kentucky",NA,2023,13438,81,13357,0.602768269
21027,"Breckinridge County, Kentucky",NA,2023,20722,30,20692,0.14477367
21029,"Bullitt County, Kentucky",NA,2023,83209,1130,82079,1.358026175
21031,"Butler County, Kentucky",NA,2023,12373,238,12135,1.923543199
21033,"Caldwell County, Kentucky",NA,2023,12631,187,12444,1.480484522
21035,"Calloway County, Kentucky",NA,2023,37882,696,37186,1.837284198
21037,"Campbell County, Kentucky",NA,2023,93193,1312,91881,1.40783106
21039,"Carlisle County, Kentucky",NA,2023,4763,37,4726,0.776821331
21041,"Carroll County, Kentucky",NA,2023,10878,227,10651,2.086780658
21043,"Carter County, Kentucky",NA,2023,26515,175,26340,0.660003771
21045,"Casey County, Kentucky",NA,2023,15951,181,15770,1.134725096
21047,"Christian County, Kentucky",NA,2023,72599,1025,71574,1.411865177
21049,"Clark County, Kentucky",NA,2023,37004,186,36818,0.502648362
21051,"Clay County, Kentucky",NA,2023,20105,148,19957,0.73613529
21053,"Clinton County, Kentucky",NA,2023,9240,80,9160,0.865800866
21055,"Crittenden County, Kentucky",NA,2023,8972,28,8944,0.312082033
21057,"Cumberland County, Kentucky",NA,2023,5948,50,5898,0.840618695
21059,"Daviess County, Kentucky",NA,2023,103195,2550,100645,2.471049954
21061,"Edmonson County, Kentucky",NA,2023,12243,29,12214,0.236870048
21063,"Elliott County, Kentucky",NA,2023,7336,5,7331,0.068157034
21065,"Estill County, Kentucky",NA,2023,14079,126,13953,0.894949925
21067,"Fayette County, Kentucky",NA,2023,321122,22304,298818,6.945646826
21069,"Fleming County, Kentucky",NA,2023,15221,55,15166,0.361342882
21071,"Floyd County, Kentucky",NA,2023,35342,137,35205,0.387640767
21073,"Franklin County, Kentucky",NA,2023,51563,1649,49914,3.198029595
21075,"Fulton County, Kentucky",NA,2023,6440,0,6440,0
21077,"Gallatin County, Kentucky",NA,2023,8749,150,8599,1.714481655
21079,"Garrard County, Kentucky",NA,2023,17346,239,17107,1.377839271
21081,"Grant County, Kentucky",NA,2023,25238,60,25178,0.237736746
21083,"Graves County, Kentucky",NA,2023,36612,515,36097,1.406642631
21085,"Grayson County, Kentucky",NA,2023,26586,146,26440,0.549161213
21087,"Green County, Kentucky",NA,2023,11278,11,11267,0.097535024
21089,"Greenup County, Kentucky",NA,2023,35639,169,35470,0.474199613
21091,"Hancock County, Kentucky",NA,2023,9032,23,9009,0.254650133
21093,"Hardin County, Kentucky",NA,2023,111452,1880,109572,1.686824821
21095,"Harlan County, Kentucky",NA,2023,26185,21,26164,0.080198587
21097,"Harrison County, Kentucky",NA,2023,18971,75,18896,0.395340256
21099,"Hart County, Kentucky",NA,2023,19470,73,19397,0.374935799
21101,"Henderson County, Kentucky",NA,2023,44493,282,44211,0.633807565
21103,"Henry County, Kentucky",NA,2023,15774,191,15583,1.210853303
21105,"Hickman County, Kentucky",NA,2023,4470,4,4466,0.089485459
21107,"Hopkins County, Kentucky",NA,2023,45143,541,44602,1.198413929
21109,"Jackson County, Kentucky",NA,2023,13003,28,12975,0.215334923
21111,"Jefferson County, Kentucky",NA,2023,777392,41282,736110,5.310319633
21113,"Jessamine County, Kentucky",NA,2023,53792,1190,52602,2.212224866
21115,"Johnson County, Kentucky",NA,2023,22464,126,22338,0.560897436
21117,"Kenton County, Kentucky",NA,2023,169817,4431,165386,2.609279401
21119,"Knott County, Kentucky",NA,2023,14046,39,14007,0.27765912
21121,"Knox County, Kentucky",NA,2023,30034,116,29918,0.386228941
21123,"Larue County, Kentucky",NA,2023,15028,41,14987,0.272824062
21125,"Laurel County, Kentucky",NA,2023,62731,321,62410,0.511708725
21127,"Lawrence County, Kentucky",NA,2023,16171,0,16171,0
21129,"Lee County, Kentucky",NA,2023,7375,14,7361,0.189830508
21131,"Leslie County, Kentucky",NA,2023,10261,11,10250,0.107202027
21133,"Letcher County, Kentucky",NA,2023,21146,14,21132,0.066206375
21135,"Lewis County, Kentucky",NA,2023,13028,13,13015,0.099785078
21137,"Lincoln County, Kentucky",NA,2023,24415,38,24377,0.155642023
21139,"Livingston County, Kentucky",NA,2023,8941,0,8941,0
21141,"Logan County, Kentucky",NA,2023,27731,93,27638,0.335364754
21143,"Lyon County, Kentucky",NA,2023,8831,70,8761,0.792662213
21145,"McCracken County, Kentucky",NA,2023,67584,571,67013,0.844874527
21147,"McCreary County, Kentucky",NA,2023,16905,30,16875,0.177462289
21149,"McLean County, Kentucky",NA,2023,9127,56,9071,0.61356415
21151,"Madison County, Kentucky",NA,2023,94064,1336,92728,1.420309576
21153,"Magoffin County, Kentucky",NA,2023,11495,43,11452,0.374075685
21155,"Marion County, Kentucky",NA,2023,19680,318,19362,1.615853659
21157,"Marshall County, Kentucky",NA,2023,31728,77,31651,0.242687847
21159,"Martin County, Kentucky",NA,2023,11181,57,11124,0.5097934
21161,"Mason County, Kentucky",NA,2023,16995,164,16831,0.964989703
21163,"Meade County, Kentucky",NA,2023,30032,239,29793,0.795817794
21165,"Menifee County, Kentucky",NA,2023,6203,0,6203,0
21167,"Mercer County, Kentucky",NA,2023,22824,441,22383,1.932176656
21169,"Metcalfe County, Kentucky",NA,2023,10372,130,10242,1.25337447
21171,"Monroe County, Kentucky",NA,2023,11318,175,11143,1.546209578
21173,"Montgomery County, Kentucky",NA,2023,28271,278,27993,0.983339818
21175,"Morgan County, Kentucky",NA,2023,13938,203,13735,1.456449993
21177,"Muhlenberg County, Kentucky",NA,2023,30712,232,30480,0.755405053
21179,"Nelson County, Kentucky",NA,2023,47102,662,46440,1.40546049
21181,"Nicholas County, Kentucky",NA,2023,7655,6,7649,0.078380144
21183,"Ohio County, Kentucky",NA,2023,23704,414,23290,1.746540668
21185,"Oldham County, Kentucky",NA,2023,68600,899,67701,1.310495627
21187,"Owen County, Kentucky",NA,2023,11270,105,11165,0.931677019
21189,"Owsley County, Kentucky",NA,2023,4021,0,4021,0
21191,"Pendleton County, Kentucky",NA,2023,14683,54,14629,0.367772254
21193,"Perry County, Kentucky",NA,2023,27847,82,27765,0.29446619
21195,"Pike County, Kentucky",NA,2023,57466,256,57210,0.445480806
21197,"Powell County, Kentucky",NA,2023,13057,0,13057,0
21199,"Pulaski County, Kentucky",NA,2023,65503,673,64830,1.027433858
21201,"Robertson County, Kentucky",NA,2023,2239,2,2237,0.089325592
21203,"Rockcastle County, Kentucky",NA,2023,16144,25,16119,0.154856293
21205,"Rowan County, Kentucky",NA,2023,24525,329,24196,1.341488277
21207,"Russell County, Kentucky",NA,2023,18117,198,17919,1.092896175
21209,"Scott County, Kentucky",NA,2023,58269,784,57485,1.345483877
21211,"Shelby County, Kentucky",NA,2023,48599,1962,46637,4.037120105
21213,"Simpson County, Kentucky",NA,2023,19786,145,19641,0.732841403
21215,"Spencer County, Kentucky",NA,2023,19875,70,19805,0.352201258
21217,"Taylor County, Kentucky",NA,2023,26205,191,26014,0.728868537
21219,"Todd County, Kentucky",NA,2023,12330,148,12182,1.200324412
21221,"Trigg County, Kentucky",NA,2023,14211,175,14036,1.231440433
21223,"Trimble County, Kentucky",NA,2023,8531,37,8494,0.433712343
21225,"Union County, Kentucky",NA,2023,13379,46,13333,0.343822408
21227,"Warren County, Kentucky",NA,2023,137549,8884,128665,6.458789231
21229,"Washington County, Kentucky",NA,2023,12091,72,12019,0.595484244
21231,"Wayne County, Kentucky",NA,2023,19592,218,19374,1.112699061
21233,"Webster County, Kentucky",NA,2023,12873,410,12463,3.184960771
21235,"Whitley County, Kentucky",NA,2023,36755,177,36578,0.481567134
21237,"Wolfe County, Kentucky",NA,2023,6484,102,6382,1.573103023
21239,"Woodford County, Kentucky",NA,2023,27017,1213,25804,4.489765703
22001,"Acadia Parish, Louisiana",NA,2023,57218,216,57002,0.377503583
22003,"Allen Parish, Louisiana",NA,2023,22552,1357,21195,6.017204683
22005,"Ascension Parish, Louisiana",NA,2023,128593,3915,124678,3.044489202
22007,"Assumption Parish, Louisiana",NA,2023,20720,222,20498,1.071428571
22009,"Avoyelles Parish, Louisiana",NA,2023,39176,338,38838,0.862773126
22011,"Beauregard Parish, Louisiana",NA,2023,36646,186,36460,0.507558806
22013,"Bienville Parish, Louisiana",NA,2023,12769,88,12681,0.689169081
22015,"Bossier Parish, Louisiana",NA,2023,129134,2954,126180,2.28754627
22017,"Caddo Parish, Louisiana",NA,2023,232973,2876,230097,1.234477815
22019,"Calcasieu Parish, Louisiana",NA,2023,208668,4122,204546,1.975386739
22021,"Caldwell Parish, Louisiana",NA,2023,9563,46,9517,0.4810206
22023,"Cameron Parish, Louisiana",NA,2023,5222,12,5210,0.229797013
22025,"Catahoula Parish, Louisiana",NA,2023,8738,8,8730,0.091554131
22027,"Claiborne Parish, Louisiana",NA,2023,14019,32,13987,0.228261645
22029,"Concordia Parish, Louisiana",NA,2023,18325,439,17886,2.395634379
22031,"De Soto Parish, Louisiana",NA,2023,26897,113,26784,0.420121203
22033,"East Baton Rouge Parish, Louisiana",NA,2023,452821,19589,433232,4.325991948
22035,"East Carroll Parish, Louisiana",NA,2023,7195,0,7195,0
22037,"East Feliciana Parish, Louisiana",NA,2023,19378,39,19339,0.20125916
22039,"Evangeline Parish, Louisiana",NA,2023,32162,993,31169,3.087494559
22041,"Franklin Parish, Louisiana",NA,2023,19590,28,19562,0.142930066
22043,"Grant Parish, Louisiana",NA,2023,22123,686,21437,3.100845274
22045,"Iberia Parish, Louisiana",NA,2023,69194,866,68328,1.251553603
22047,"Iberville Parish, Louisiana",NA,2023,29950,550,29400,1.83639399
22049,"Jackson Parish, Louisiana",NA,2023,14939,268,14671,1.793962113
22051,"Jefferson Parish, Louisiana",NA,2023,432484,35695,396789,8.253484522
22053,"Jefferson Davis Parish, Louisiana",NA,2023,32083,125,31958,0.389614438
22055,"Lafayette Parish, Louisiana",NA,2023,245075,7852,237223,3.203917168
22057,"Lafourche Parish, Louisiana",NA,2023,96670,1646,95024,1.702699907
22059,"LaSalle Parish, Louisiana",NA,2023,14804,138,14666,0.932180492
22061,"Lincoln Parish, Louisiana",NA,2023,48160,581,47579,1.206395349
22063,"Livingston Parish, Louisiana",NA,2023,145583,4333,141250,2.976309047
22065,"Madison Parish, Louisiana",NA,2023,9757,59,9698,0.604694066
22067,"Morehouse Parish, Louisiana",NA,2023,24967,93,24874,0.372491689
22069,"Natchitoches Parish, Louisiana",NA,2023,37047,263,36784,0.709909034
22071,"Orleans Parish, Louisiana",NA,2023,376035,12571,363464,3.343039877
22073,"Ouachita Parish, Louisiana",NA,2023,158916,1864,157052,1.172946714
22075,"Plaquemines Parish, Louisiana",NA,2023,23070,571,22499,2.475075856
22077,"Pointe Coupee Parish, Louisiana",NA,2023,20438,102,20336,0.499070359
22079,"Rapides Parish, Louisiana",NA,2023,128470,2259,126211,1.758387172
22081,"Red River Parish, Louisiana",NA,2023,7529,8,7521,0.106255811
22083,"Richland Parish, Louisiana",NA,2023,19908,22,19886,0.110508338
22085,"Sabine Parish, Louisiana",NA,2023,22085,86,21999,0.389404573
22087,"St. Bernard Parish, Louisiana",NA,2023,44172,1243,42929,2.813999819
22089,"St. Charles Parish, Louisiana",NA,2023,51863,1071,50792,2.065056013
22091,"St. Helena Parish, Louisiana",NA,2023,10849,226,10623,2.083141303
22093,"St. James Parish, Louisiana",NA,2023,19797,117,19680,0.590998636
22095,"St. John the Baptist Parish, Louisiana",NA,2023,41342,654,40688,1.58192637
22097,"St. Landry Parish, Louisiana",NA,2023,82128,765,81363,0.931472823
22099,"St. Martin Parish, Louisiana",NA,2023,51559,697,50862,1.351849338
22101,"St. Mary Parish, Louisiana",NA,2023,48455,1430,47025,2.951191827
22103,"St. Tammany Parish, Louisiana",NA,2023,269331,6563,262768,2.436778536
22105,"Tangipahoa Parish, Louisiana",NA,2023,135218,2171,133047,1.605555473
22107,"Tensas Parish, Louisiana",NA,2023,3992,22,3970,0.551102204
22109,"Terrebonne Parish, Louisiana",NA,2023,107362,2427,104935,2.260576368
22111,"Union Parish, Louisiana",NA,2023,20914,410,20504,1.960409295
22113,"Vermilion Parish, Louisiana",NA,2023,57031,807,56224,1.415019901
22115,"Vernon Parish, Louisiana",NA,2023,47764,667,47097,1.396449209
22117,"Washington Parish, Louisiana",NA,2023,45238,248,44990,0.54821168
22119,"Webster Parish, Louisiana",NA,2023,36189,229,35960,0.632788969
22121,"West Baton Rouge Parish, Louisiana",NA,2023,27666,301,27365,1.087978024
22123,"West Carroll Parish, Louisiana",NA,2023,9622,31,9591,0.322178341
22125,"West Feliciana Parish, Louisiana",NA,2023,15381,50,15331,0.325076393
22127,"Winn Parish, Louisiana",NA,2023,13506,587,12919,4.346216496
23001,"Androscoggin County, Maine",NA,2023,112323,2850,109473,2.537325392
23003,"Aroostook County, Maine",NA,2023,67227,975,66252,1.450310143
23005,"Cumberland County, Maine",NA,2023,305940,9688,296252,3.166633981
23007,"Franklin County, Maine",NA,2023,30145,328,29817,1.088074308
23009,"Hancock County, Maine",NA,2023,56084,777,55307,1.385421867
23011,"Kennebec County, Maine",NA,2023,125614,1131,124483,0.900377346
23013,"Knox County, Maine",NA,2023,40860,579,40281,1.417033774
23015,"Lincoln County, Maine",NA,2023,35840,188,35652,0.524553571
23017,"Oxford County, Maine",NA,2023,58728,437,58291,0.744108432
23019,"Penobscot County, Maine",NA,2023,153571,2361,151210,1.537399639
23021,"Piscataquis County, Maine",NA,2023,17125,222,16903,1.296350365
23023,"Sagadahoc County, Maine",NA,2023,37093,360,36733,0.970533524
23025,"Somerset County, Maine",NA,2023,50852,299,50553,0.587980807
23027,"Waldo County, Maine",NA,2023,40006,388,39618,0.969854522
23029,"Washington County, Maine",NA,2023,31261,424,30837,1.356322574
23031,"York County, Maine",NA,2023,214731,3308,211423,1.540532108
24001,"Allegany County, Maryland",NA,2023,67762,649,67113,0.957763938
24003,"Anne Arundel County, Maryland",NA,2023,590936,24315,566621,4.114658779
24005,"Baltimore County, Maryland",NA,2023,849586,45106,804480,5.309174115
24009,"Calvert County, Maryland",NA,2023,93791,982,92809,1.047008775
24011,"Caroline County, Maryland",NA,2023,33406,1658,31748,4.963180267
24013,"Carroll County, Maryland",NA,2023,174318,3733,170585,2.141488544
24015,"Cecil County, Maryland",NA,2023,104366,1628,102738,1.559894985
24017,"Charles County, Maryland",NA,2023,168710,5705,163005,3.381542292
24019,"Dorchester County, Maryland",NA,2023,32612,664,31948,2.036060346
24021,"Frederick County, Maryland",NA,2023,280341,14916,265425,5.32066305
24023,"Garrett County, Maryland",NA,2023,28713,208,28505,0.724410546
24025,"Harford County, Maryland",NA,2023,262509,4960,257549,1.889459028
24027,"Howard County, Maryland",NA,2023,333916,25083,308833,7.511769427
24029,"Kent County, Maryland",NA,2023,19265,316,18949,1.640280301
24031,"Montgomery County, Maryland",NA,2023,1057586,149672,907914,14.1522297
24033,"Prince George's County, Maryland",NA,2023,955584,135204,820380,14.14883464
24035,"Queen Anne's County, Maryland",NA,2023,50951,1455,49496,2.855684874
24037,"St. Mary's County, Maryland",NA,2023,114372,2076,112296,1.815129577
24039,"Somerset County, Maryland",NA,2023,24685,567,24118,2.296941462
24041,"Talbot County, Maryland",NA,2023,37707,1837,35870,4.871774472
24043,"Washington County, Maryland",NA,2023,155033,4867,150166,3.139331626
24045,"Wicomico County, Maryland",NA,2023,104117,5806,98311,5.576418837
24047,"Worcester County, Maryland",NA,2023,53279,1326,51953,2.48878545
24510,"Baltimore city, Maryland",NA,2023,577193,26912,550281,4.662565208
25001,"Barnstable County, Massachusetts",NA,2023,230073,9744,220329,4.235177531
25003,"Berkshire County, Massachusetts",NA,2023,128047,3190,124857,2.491272736
25005,"Bristol County, Massachusetts",NA,2023,578436,30420,548016,5.259008775
25007,"Dukes County, Massachusetts",NA,2023,20751,1582,19169,7.623728977
25009,"Essex County, Massachusetts",NA,2023,807258,66123,741135,8.191061594
25011,"Franklin County, Massachusetts",NA,2023,70922,1632,69290,2.30111954
25013,"Hampden County, Massachusetts",NA,2023,462853,16492,446361,3.563118312
25015,"Hampshire County, Massachusetts",NA,2023,156595,5852,150743,3.737028641
25017,"Middlesex County, Massachusetts",NA,2023,1622896,179826,1443070,11.08056216
25019,"Nantucket County, Massachusetts",NA,2023,14299,1083,13216,7.573956221
25021,"Norfolk County, Massachusetts",NA,2023,724540,55233,669307,7.623181605
25023,"Plymouth County, Massachusetts",NA,2023,531889,21482,510407,4.038812609
25025,"Suffolk County, Massachusetts",NA,2023,782172,114347,667825,14.61916305
25027,"Worcester County, Massachusetts",NA,2023,861664,55553,806111,6.447176626
26001,"Alcona County, Michigan",NA,2023,10310,56,10254,0.543161979
26003,"Alger County, Michigan",NA,2023,8813,45,8768,0.510609327
26005,"Allegan County, Michigan",NA,2023,120913,2419,118494,2.00061201
26007,"Alpena County, Michigan",NA,2023,28908,170,28738,0.588072506
26009,"Antrim County, Michigan",NA,2023,23876,216,23660,0.90467415
26011,"Arenac County, Michigan",NA,2023,15054,64,14990,0.425136176
26013,"Baraga County, Michigan",NA,2023,8249,14,8235,0.169717542
26015,"Barry County, Michigan",NA,2023,62982,679,62303,1.078085802
26017,"Bay County, Michigan",NA,2023,103235,456,102779,0.44171066
26019,"Benzie County, Michigan",NA,2023,18177,96,18081,0.528139957
26021,"Berrien County, Michigan",NA,2023,153411,4240,149171,2.763817458
26023,"Branch County, Michigan",NA,2023,44914,1418,43496,3.157144766
26025,"Calhoun County, Michigan",NA,2023,133846,2932,130914,2.190577231
26027,"Cass County, Michigan",NA,2023,51606,532,51074,1.030887881
26029,"Charlevoix County, Michigan",NA,2023,26143,135,26008,0.516390621
26031,"Cheboygan County, Michigan",NA,2023,25778,128,25650,0.496547444
26033,"Chippewa County, Michigan",NA,2023,36448,520,35928,1.426690079
26035,"Clare County, Michigan",NA,2023,31109,73,31036,0.23465878
26037,"Clinton County, Michigan",NA,2023,79419,797,78622,1.003538196
26039,"Crawford County, Michigan",NA,2023,13271,82,13189,0.617888629
26041,"Delta County, Michigan",NA,2023,36829,83,36746,0.22536588
26043,"Dickinson County, Michigan",NA,2023,25940,173,25767,0.66692367
26045,"Eaton County, Michigan",NA,2023,109000,2169,106831,1.989908257
26047,"Emmet County, Michigan",NA,2023,34159,161,33998,0.471325273
26049,"Genesee County, Michigan",NA,2023,404087,4221,399866,1.044577034
26051,"Gladwin County, Michigan",NA,2023,25543,101,25442,0.395411659
26053,"Gogebic County, Michigan",NA,2023,14348,42,14306,0.292723725
26055,"Grand Traverse County, Michigan",NA,2023,95757,663,95094,0.692377581
26057,"Gratiot County, Michigan",NA,2023,41478,333,41145,0.802835238
26059,"Hillsdale County, Michigan",NA,2023,45658,225,45433,0.492794253
26061,"Houghton County, Michigan",NA,2023,37428,1396,36032,3.729827936
26063,"Huron County, Michigan",NA,2023,31258,267,30991,0.85418133
26065,"Ingham County, Michigan",NA,2023,282015,15197,266818,5.388720458
26067,"Ionia County, Michigan",NA,2023,66706,450,66256,0.674601985
26069,"Iosco County, Michigan",NA,2023,25333,173,25160,0.682903722
26071,"Iron County, Michigan",NA,2023,11650,31,11619,0.266094421
26073,"Isabella County, Michigan",NA,2023,64475,1252,63223,1.941837922
26075,"Jackson County, Michigan",NA,2023,160187,1965,158222,1.226691305
26077,"Kalamazoo County, Michigan",NA,2023,261437,8593,252844,3.286833922
26079,"Kalkaska County, Michigan",NA,2023,18116,81,18035,0.447118569
26081,"Kent County, Michigan",NA,2023,658844,31834,627010,4.831796298
26083,"Keweenaw County, Michigan",NA,2023,2106,17,2089,0.807217474
26085,"Lake County, Michigan",NA,2023,12393,67,12326,0.540627774
26087,"Lapeer County, Michigan",NA,2023,88703,1031,87672,1.162305672
26089,"Leelanau County, Michigan",NA,2023,22607,144,22463,0.63697085
26091,"Lenawee County, Michigan",NA,2023,98823,1092,97731,1.10500592
26093,"Livingston County, Michigan",NA,2023,195143,1744,193399,0.893703592
26095,"Luce County, Michigan",NA,2023,6325,25,6300,0.395256917
26097,"Mackinac County, Michigan",NA,2023,10865,449,10416,4.132535665
26099,"Macomb County, Michigan",NA,2023,877624,29258,848366,3.333773917
26101,"Manistee County, Michigan",NA,2023,25247,230,25017,0.910999327
26103,"Marquette County, Michigan",NA,2023,66430,487,65943,0.733102514
26105,"Mason County, Michigan",NA,2023,29177,220,28957,0.754018576
26107,"Mecosta County, Michigan",NA,2023,40321,253,40068,0.627464597
26109,"Menominee County, Michigan",NA,2023,23295,162,23133,0.695428203
26111,"Midland County, Michigan",NA,2023,83641,873,82768,1.043746488
26113,"Missaukee County, Michigan",NA,2023,15156,150,15006,0.989707047
26115,"Monroe County, Michigan",NA,2023,155001,1629,153372,1.050960962
26117,"Montcalm County, Michigan",NA,2023,67174,1041,66133,1.549706732
26119,"Montmorency County, Michigan",NA,2023,9372,28,9344,0.298762271
26121,"Muskegon County, Michigan",NA,2023,175378,1713,173665,0.976747369
26123,"Newaygo County, Michigan",NA,2023,50414,475,49939,0.942198596
26125,"Oakland County, Michigan",NA,2023,1272294,76619,1195675,6.022114386
26127,"Oceana County, Michigan",NA,2023,26788,916,25872,3.419441541
26129,"Ogemaw County, Michigan",NA,2023,20853,153,20700,0.73370738
26131,"Ontonagon County, Michigan",NA,2023,5870,14,5856,0.238500852
26133,"Osceola County, Michigan",NA,2023,23122,79,23043,0.341665946
26135,"Oscoda County, Michigan",NA,2023,8338,24,8314,0.28783881
26137,"Otsego County, Michigan",NA,2023,25352,194,25158,0.765225623
26139,"Ottawa County, Michigan",NA,2023,298614,6971,291643,2.334451834
26141,"Presque Isle County, Michigan",NA,2023,13142,41,13101,0.311976868
26143,"Roscommon County, Michigan",NA,2023,23639,158,23481,0.668386988
26145,"Saginaw County, Michigan",NA,2023,189210,1901,187309,1.004703768
26147,"St. Clair County, Michigan",NA,2023,160089,1325,158764,0.827664612
26149,"St. Joseph County, Michigan",NA,2023,60870,1674,59196,2.750123213
26151,"Sanilac County, Michigan",NA,2023,40574,243,40331,0.598905703
26153,"Schoolcraft County, Michigan",NA,2023,8093,58,8035,0.716668726
26155,"Shiawassee County, Michigan",NA,2023,68061,283,67778,0.41580347
26157,"Tuscola County, Michigan",NA,2023,53071,197,52874,0.371200844
26159,"Van Buren County, Michigan",NA,2023,75681,2295,73386,3.032465216
26161,"Washtenaw County, Michigan",NA,2023,368394,23642,344752,6.41758552
26163,"Wayne County, Michigan",NA,2023,1773767,67401,1706366,3.799879015
26165,"Wexford County, Michigan",NA,2023,33868,282,33586,0.832644384
27001,"Aitkin County, Minnesota",NA,2023,15930,42,15888,0.263653484
27003,"Anoka County, Minnesota",NA,2023,367095,11505,355590,3.134066114
27005,"Becker County, Minnesota",NA,2023,35260,228,35032,0.646625071
27007,"Beltrami County, Minnesota",NA,2023,46421,303,46118,0.652721828
27009,"Benton County, Minnesota",NA,2023,41458,561,40897,1.353176709
27011,"Big Stone County, Minnesota",NA,2023,5152,37,5115,0.718167702
27013,"Blue Earth County, Minnesota",NA,2023,69386,2266,67120,3.265788488
27015,"Brown County, Minnesota",NA,2023,25826,358,25468,1.386199954
27017,"Carlton County, Minnesota",NA,2023,36457,278,36179,0.762542173
27019,"Carver County, Minnesota",NA,2023,108622,2410,106212,2.218703393
27021,"Cass County, Minnesota",NA,2023,30688,106,30582,0.345411887
27023,"Chippewa County, Minnesota",NA,2023,12388,675,11713,5.44882144
27025,"Chisago County, Minnesota",NA,2023,57434,572,56862,0.995925758
27027,"Clay County, Minnesota",NA,2023,65628,1177,64451,1.793441824
27029,"Clearwater County, Minnesota",NA,2023,8579,34,8545,0.396316587
27031,"Cook County, Minnesota",NA,2023,5633,104,5529,1.846263092
27033,"Cottonwood County, Minnesota",NA,2023,11458,415,11043,3.621923547
27035,"Crow Wing County, Minnesota",NA,2023,67113,384,66729,0.572169326
27037,"Dakota County, Minnesota",NA,2023,442204,17547,424657,3.968078082
27039,"Dodge County, Minnesota",NA,2023,20962,540,20422,2.576090068
27041,"Douglas County, Minnesota",NA,2023,39354,161,39193,0.409107079
27043,"Faribault County, Minnesota",NA,2023,13909,220,13689,1.581709684
27045,"Fillmore County, Minnesota",NA,2023,21346,141,21205,0.660545301
27047,"Freeborn County, Minnesota",NA,2023,30752,446,30306,1.450312175
27049,"Goodhue County, Minnesota",NA,2023,47844,870,46974,1.818409832
27051,"Grant County, Minnesota",NA,2023,6108,13,6095,0.212835625
27053,"Hennepin County, Minnesota",NA,2023,1268903,74518,1194385,5.872631714
27055,"Houston County, Minnesota",NA,2023,18768,52,18716,0.277067349
27057,"Hubbard County, Minnesota",NA,2023,21700,77,21623,0.35483871
27059,"Isanti County, Minnesota",NA,2023,41934,422,41512,1.006343301
27061,"Itasca County, Minnesota",NA,2023,45141,177,44964,0.392104738
27063,"Jackson County, Minnesota",NA,2023,9964,110,9854,1.103974308
27065,"Kanabec County, Minnesota",NA,2023,16261,56,16205,0.344382264
27067,"Kandiyohi County, Minnesota",NA,2023,43757,2605,41152,5.953333181
27069,"Kittson County, Minnesota",NA,2023,4163,43,4120,1.03290896
27071,"Koochiching County, Minnesota",NA,2023,11950,168,11782,1.405857741
27073,"Lac qui Parle County, Minnesota",NA,2023,6694,79,6615,1.180161339
27075,"Lake County, Minnesota",NA,2023,10911,35,10876,0.320777197
27077,"Lake of the Woods County, Minnesota",NA,2023,3800,45,3755,1.184210526
27079,"Le Sueur County, Minnesota",NA,2023,28936,610,28326,2.108100636
27081,"Lincoln County, Minnesota",NA,2023,5594,32,5562,0.572041473
27083,"Lyon County, Minnesota",NA,2023,25498,896,24602,3.514001098
27085,"McLeod County, Minnesota",NA,2023,36771,644,36127,1.751380164
27087,"Mahnomen County, Minnesota",NA,2023,5371,15,5356,0.279277602
27089,"Marshall County, Minnesota",NA,2023,8961,67,8894,0.74768441
27091,"Martin County, Minnesota",NA,2023,19864,237,19627,1.19311317
27093,"Meeker County, Minnesota",NA,2023,23422,203,23219,0.866706515
27095,"Mille Lacs County, Minnesota",NA,2023,26912,149,26763,0.553656361
27097,"Morrison County, Minnesota",NA,2023,34131,124,34007,0.363306085
27099,"Mower County, Minnesota",NA,2023,40069,2905,37164,7.249993761
27101,"Murray County, Minnesota",NA,2023,8119,158,7961,1.94605247
27103,"Nicollet County, Minnesota",NA,2023,34350,824,33526,2.398835517
27105,"Nobles County, Minnesota",NA,2023,22067,3221,18846,14.59645625
27107,"Norman County, Minnesota",NA,2023,6411,74,6337,1.154266105
27109,"Olmsted County, Minnesota",NA,2023,163425,7612,155813,4.657794095
27111,"Otter Tail County, Minnesota",NA,2023,60281,709,59572,1.176158325
27113,"Pennington County, Minnesota",NA,2023,13877,190,13687,1.369172011
27115,"Pine County, Minnesota",NA,2023,29411,208,29203,0.707218388
27117,"Pipestone County, Minnesota",NA,2023,9352,373,8979,3.988451668
27119,"Polk County, Minnesota",NA,2023,30905,384,30521,1.242517392
27121,"Pope County, Minnesota",NA,2023,11363,29,11334,0.255214292
27123,"Ramsey County, Minnesota",NA,2023,544438,32237,512201,5.92115172
27125,"Red Lake County, Minnesota",NA,2023,3922,12,3910,0.305966344
27127,"Redwood County, Minnesota",NA,2023,15383,119,15264,0.773581226
27129,"Renville County, Minnesota",NA,2023,14587,340,14247,2.330842531
27131,"Rice County, Minnesota",NA,2023,67389,3954,63435,5.867426435
27133,"Rock County, Minnesota",NA,2023,9628,104,9524,1.0801828
27135,"Roseau County, Minnesota",NA,2023,15301,212,15089,1.385530357
27137,"St. Louis County, Minnesota",NA,2023,200056,1722,198334,0.860758987
27139,"Scott County, Minnesota",NA,2023,152957,4676,148281,3.057068326
27141,"Sherburne County, Minnesota",NA,2023,99178,1236,97942,1.246244127
27143,"Sibley County, Minnesota",NA,2023,14933,431,14502,2.886225139
27145,"Stearns County, Minnesota",NA,2023,159358,5445,153913,3.416835051
27147,"Steele County, Minnesota",NA,2023,37413,968,36445,2.587335953
27149,"Stevens County, Minnesota",NA,2023,9686,569,9117,5.874457981
27151,"Swift County, Minnesota",NA,2023,9787,230,9557,2.350056197
27153,"Todd County, Minnesota",NA,2023,25402,668,24734,2.629714196
27155,"Traverse County, Minnesota",NA,2023,3279,44,3235,1.341872522
27157,"Wabasha County, Minnesota",NA,2023,21519,144,21375,0.669176077
27159,"Wadena County, Minnesota",NA,2023,14135,161,13974,1.139016625
27161,"Waseca County, Minnesota",NA,2023,18958,376,18582,1.983331575
27163,"Washington County, Minnesota",NA,2023,272298,7213,265085,2.648936092
27165,"Watonwan County, Minnesota",NA,2023,11169,905,10264,8.102784493
27167,"Wilkin County, Minnesota",NA,2023,6413,84,6329,1.309839389
27169,"Winona County, Minnesota",NA,2023,49705,741,48964,1.490795695
27171,"Wright County, Minnesota",NA,2023,145270,2225,143045,1.531630757
27173,"Yellow Medicine County, Minnesota",NA,2023,9509,180,9329,1.892943527
28001,"Adams County, Mississippi",NA,2023,29098,1276,27822,4.385181112
28003,"Alcorn County, Mississippi",NA,2023,34500,177,34323,0.513043478
28005,"Amite County, Mississippi",NA,2023,12611,23,12588,0.182380462
28007,"Attala County, Mississippi",NA,2023,17685,0,17685,0
28009,"Benton County, Mississippi",NA,2023,7592,346,7246,4.557428872
28011,"Bolivar County, Mississippi",NA,2023,30163,523,29640,1.733912409
28013,"Calhoun County, Mississippi",NA,2023,13029,331,12698,2.540486607
28015,"Carroll County, Mississippi",NA,2023,9828,66,9762,0.671550672
28017,"Chickasaw County, Mississippi",NA,2023,16994,266,16728,1.565258326
28019,"Choctaw County, Mississippi",NA,2023,8172,0,8172,0
28021,"Claiborne County, Mississippi",NA,2023,8908,48,8860,0.538841491
28023,"Clarke County, Mississippi",NA,2023,15424,24,15400,0.15560166
28025,"Clay County, Mississippi",NA,2023,18462,55,18407,0.297909219
28027,"Coahoma County, Mississippi",NA,2023,20808,242,20566,1.163014225
28029,"Copiah County, Mississippi",NA,2023,27994,159,27835,0.567978853
28031,"Covington County, Mississippi",NA,2023,18226,51,18175,0.279820037
28033,"DeSoto County, Mississippi",NA,2023,188598,3826,184772,2.028653538
28035,"Forrest County, Mississippi",NA,2023,78027,1420,76607,1.819882861
28037,"Franklin County, Mississippi",NA,2023,7655,22,7633,0.28739386
28039,"George County, Mississippi",NA,2023,24870,67,24803,0.269400885
28041,"Greene County, Mississippi",NA,2023,13595,98,13497,0.720853255
28043,"Grenada County, Mississippi",NA,2023,21342,190,21152,0.890263331
28045,"Hancock County, Mississippi",NA,2023,46057,394,45663,0.85546171
28047,"Harrison County, Mississippi",NA,2023,209443,4436,205007,2.117998692
28049,"Hinds County, Mississippi",NA,2023,222494,2737,219757,1.230145532
28051,"Holmes County, Mississippi",NA,2023,16491,24,16467,0.145533928
28053,"Humphreys County, Mississippi",NA,2023,7570,17,7553,0.224570674
28055,"Issaquena County, Mississippi",NA,2023,1095,0,1095,0
28057,"Itawamba County, Mississippi",NA,2023,23942,58,23884,0.242252109
28059,"Jackson County, Mississippi",NA,2023,144437,2004,142433,1.387456123
28061,"Jasper County, Mississippi",NA,2023,16211,34,16177,0.209734131
28063,"Jefferson County, Mississippi",NA,2023,7127,16,7111,0.224498386
28065,"Jefferson Davis County, Mississippi",NA,2023,11183,4,11179,0.035768577
28067,"Jones County, Mississippi",NA,2023,66839,1438,65401,2.151438531
28069,"Kemper County, Mississippi",NA,2023,8855,11,8844,0.124223602
28071,"Lafayette County, Mississippi",NA,2023,56920,1403,55517,2.464862966
28073,"Lamar County, Mississippi",NA,2023,65081,1019,64062,1.565741153
28075,"Lauderdale County, Mississippi",NA,2023,71984,639,71345,0.887697266
28077,"Lawrence County, Mississippi",NA,2023,11883,0,11883,0
28079,"Leake County, Mississippi",NA,2023,21288,540,20748,2.536640361
28081,"Lee County, Mississippi",NA,2023,83138,1284,81854,1.544420121
28083,"Leflore County, Mississippi",NA,2023,27432,117,27315,0.426509186
28085,"Lincoln County, Mississippi",NA,2023,34830,146,34684,0.419178869
28087,"Lowndes County, Mississippi",NA,2023,58187,659,57528,1.132555382
28089,"Madison County, Mississippi",NA,2023,110303,2764,107539,2.505824864
28091,"Marion County, Mississippi",NA,2023,24303,89,24214,0.366209933
28093,"Marshall County, Mississippi",NA,2023,33899,396,33503,1.168176052
28095,"Monroe County, Mississippi",NA,2023,33928,175,33753,0.515798161
28097,"Montgomery County, Mississippi",NA,2023,9708,18,9690,0.185414091
28099,"Neshoba County, Mississippi",NA,2023,28927,157,28770,0.542745532
28101,"Newton County, Mississippi",NA,2023,21151,40,21111,0.189116354
28103,"Noxubee County, Mississippi",NA,2023,10136,43,10093,0.424230466
28105,"Oktibbeha County, Mississippi",NA,2023,51473,1759,49714,3.417325588
28107,"Panola County, Mississippi",NA,2023,32965,90,32875,0.273016836
28109,"Pearl River County, Mississippi",NA,2023,56781,424,56357,0.746728659
28111,"Perry County, Mississippi",NA,2023,11459,36,11423,0.31416354
28113,"Pike County, Mississippi",NA,2023,39930,139,39791,0.348109191
28115,"Pontotoc County, Mississippi",NA,2023,31312,837,30475,2.673096576
28117,"Prentiss County, Mississippi",NA,2023,24999,257,24742,1.028041122
28119,"Quitman County, Mississippi",NA,2023,5908,4,5904,0.067704807
28121,"Rankin County, Mississippi",NA,2023,158218,2201,156017,1.391118583
28123,"Scott County, Mississippi",NA,2023,27754,1218,26536,4.388556604
28125,"Sharkey County, Mississippi",NA,2023,3848,0,3848,0
28127,"Simpson County, Mississippi",NA,2023,25817,193,25624,0.747569431
28129,"Smith County, Mississippi",NA,2023,14193,38,14155,0.267737617
28131,"Stone County, Mississippi",NA,2023,18515,91,18424,0.491493384
28133,"Sunflower County, Mississippi",NA,2023,25328,304,25024,1.200252685
28135,"Tallahatchie County, Mississippi",NA,2023,12363,54,12309,0.436787188
28137,"Tate County, Mississippi",NA,2023,28135,224,27911,0.796161365
28139,"Tippah County, Mississippi",NA,2023,21621,354,21267,1.637297072
28141,"Tishomingo County, Mississippi",NA,2023,18738,260,18478,1.387554702
28143,"Tunica County, Mississippi",NA,2023,9586,25,9561,0.260796996
28145,"Union County, Mississippi",NA,2023,28009,537,27472,1.917240887
28147,"Walthall County, Mississippi",NA,2023,13864,149,13715,1.074725909
28149,"Warren County, Mississippi",NA,2023,43623,272,43351,0.623524288
28151,"Washington County, Mississippi",NA,2023,43674,85,43589,0.194623804
28153,"Wayne County, Mississippi",NA,2023,19699,788,18911,4.000203056
28155,"Webster County, Mississippi",NA,2023,9942,25,9917,0.251458459
28157,"Wilkinson County, Mississippi",NA,2023,8376,0,8376,0
28159,"Winston County, Mississippi",NA,2023,17609,26,17583,0.147651769
28161,"Yalobusha County, Mississippi",NA,2023,12439,1,12438,0.008039231
28163,"Yazoo County, Mississippi",NA,2023,26837,833,26004,3.103923687
29001,"Adair County, Missouri",NA,2023,25224,828,24396,3.282588011
29003,"Andrew County, Missouri",NA,2023,18086,34,18052,0.187990711
29005,"Atchison County, Missouri",NA,2023,5216,22,5194,0.421779141
29007,"Audrain County, Missouri",NA,2023,24688,138,24550,0.558976021
29009,"Barry County, Missouri",NA,2023,34831,847,33984,2.431741839
29011,"Barton County, Missouri",NA,2023,11685,10,11675,0.085579803
29013,"Bates County, Missouri",NA,2023,16121,55,16066,0.341169903
29015,"Benton County, Missouri",NA,2023,19887,87,19800,0.437471715
29017,"Bollinger County, Missouri",NA,2023,10591,1,10590,0.009441979
29019,"Boone County, Missouri",NA,2023,185874,7059,178815,3.797733949
29021,"Buchanan County, Missouri",NA,2023,83855,1581,82274,1.885397412
29023,"Butler County, Missouri",NA,2023,42166,198,41968,0.469572641
29025,"Caldwell County, Missouri",NA,2023,8890,38,8852,0.427446569
29027,"Callaway County, Missouri",NA,2023,44541,219,44322,0.491681821
29029,"Camden County, Missouri",NA,2023,43416,420,42996,0.967385296
29031,"Cape Girardeau County, Missouri",NA,2023,82180,1084,81096,1.319055731
29033,"Carroll County, Missouri",NA,2023,8459,6,8453,0.07093037
29035,"Carter County, Missouri",NA,2023,5269,43,5226,0.816094136
29037,"Cass County, Missouri",NA,2023,109393,692,108701,0.632581609
29039,"Cedar County, Missouri",NA,2023,14440,59,14381,0.408587258
29041,"Chariton County, Missouri",NA,2023,7406,68,7338,0.918174453
29043,"Christian County, Missouri",NA,2023,91229,1231,89998,1.349351632
29045,"Clark County, Missouri",NA,2023,6680,14,6666,0.209580838
29047,"Clay County, Missouri",NA,2023,255566,5209,250357,2.038221047
29049,"Clinton County, Missouri",NA,2023,21259,138,21121,0.649136836
29051,"Cole County, Missouri",NA,2023,76924,1194,75730,1.552181374
29053,"Cooper County, Missouri",NA,2023,16835,42,16793,0.249480249
29055,"Crawford County, Missouri",NA,2023,22890,57,22833,0.249017038
29057,"Dade County, Missouri",NA,2023,7627,26,7601,0.340894192
29059,"Dallas County, Missouri",NA,2023,17344,21,17323,0.121079336
29061,"Daviess County, Missouri",NA,2023,8449,37,8412,0.437921648
29063,"DeKalb County, Missouri",NA,2023,11176,146,11030,1.306370795
29065,"Dent County, Missouri",NA,2023,14506,120,14386,0.827243899
29067,"Douglas County, Missouri",NA,2023,11850,72,11778,0.607594937
29069,"Dunklin County, Missouri",NA,2023,27795,582,27213,2.093901781
29071,"Franklin County, Missouri",NA,2023,105316,872,104444,0.827984352
29073,"Gasconade County, Missouri",NA,2023,14774,22,14752,0.148910248
29075,"Gentry County, Missouri",NA,2023,6224,30,6194,0.482005141
29077,"Greene County, Missouri",NA,2023,301121,5526,295595,1.835142684
29079,"Grundy County, Missouri",NA,2023,9822,56,9766,0.570148646
29081,"Harrison County, Missouri",NA,2023,8198,68,8130,0.829470603
29083,"Henry County, Missouri",NA,2023,22194,80,22114,0.360457781
29085,"Hickory County, Missouri",NA,2023,8501,0,8501,0
29087,"Holt County, Missouri",NA,2023,4254,22,4232,0.51716032
29089,"Howard County, Missouri",NA,2023,10141,44,10097,0.43388226
29091,"Howell County, Missouri",NA,2023,40168,204,39964,0.507866959
29093,"Iron County, Missouri",NA,2023,9482,35,9447,0.369120439
29095,"Jackson County, Missouri",NA,2023,717021,24657,692364,3.438811416
29097,"Jasper County, Missouri",NA,2023,123532,3366,120166,2.724800052
29099,"Jefferson County, Missouri",NA,2023,228227,1473,226754,0.645410052
29101,"Johnson County, Missouri",NA,2023,54331,972,53359,1.789033885
29103,"Knox County, Missouri",NA,2023,3760,4,3756,0.106382979
29105,"Laclede County, Missouri",NA,2023,36245,239,36006,0.659401297
29107,"Lafayette County, Missouri",NA,2023,32974,399,32575,1.210044277
29109,"Lawrence County, Missouri",NA,2023,38392,792,37600,2.062929777
29111,"Lewis County, Missouri",NA,2023,9945,64,9881,0.643539467
29113,"Lincoln County, Missouri",NA,2023,61636,323,61313,0.52404439
29115,"Linn County, Missouri",NA,2023,11850,60,11790,0.506329114
29117,"Livingston County, Missouri",NA,2023,14330,69,14261,0.481507327
29119,"McDonald County, Missouri",NA,2023,23492,1873,21619,7.972926954
29121,"Macon County, Missouri",NA,2023,15163,42,15121,0.276990042
29123,"Madison County, Missouri",NA,2023,12665,79,12586,0.623766285
29125,"Maries County, Missouri",NA,2023,8435,68,8367,0.80616479
29127,"Marion County, Missouri",NA,2023,28493,106,28387,0.372021198
29129,"Mercer County, Missouri",NA,2023,3501,77,3424,2.199371608
29131,"Miller County, Missouri",NA,2023,25081,204,24877,0.813364698
29133,"Mississippi County, Missouri",NA,2023,12079,66,12013,0.546402848
29135,"Moniteau County, Missouri",NA,2023,15303,186,15117,1.215447951
29137,"Monroe County, Missouri",NA,2023,8672,68,8604,0.784132841
29139,"Montgomery County, Missouri",NA,2023,11422,44,11378,0.385221502
29141,"Morgan County, Missouri",NA,2023,21430,67,21363,0.312645824
29143,"New Madrid County, Missouri",NA,2023,16041,80,15961,0.498722025
29145,"Newton County, Missouri",NA,2023,59490,1815,57675,3.05093293
29147,"Nodaway County, Missouri",NA,2023,20959,352,20607,1.67946944
29149,"Oregon County, Missouri",NA,2023,8704,28,8676,0.321691176
29151,"Osage County, Missouri",NA,2023,13379,7,13372,0.052320801
29153,"Ozark County, Missouri",NA,2023,8773,25,8748,0.284965234
29155,"Pemiscot County, Missouri",NA,2023,15232,72,15160,0.472689076
29157,"Perry County, Missouri",NA,2023,18947,221,18726,1.166411569
29159,"Pettis County, Missouri",NA,2023,43205,1658,41547,3.837518806
29161,"Phelps County, Missouri",NA,2023,44948,1258,43690,2.798789713
29163,"Pike County, Missouri",NA,2023,17623,88,17535,0.499347444
29165,"Platte County, Missouri",NA,2023,108751,2223,106528,2.044119135
29167,"Polk County, Missouri",NA,2023,32109,192,31917,0.597963188
29169,"Pulaski County, Missouri",NA,2023,53850,1260,52590,2.339832869
29171,"Putnam County, Missouri",NA,2023,4675,13,4662,0.278074866
29173,"Ralls County, Missouri",NA,2023,10394,14,10380,0.134693092
29175,"Randolph County, Missouri",NA,2023,24524,90,24434,0.366987441
29177,"Ray County, Missouri",NA,2023,23149,125,23024,0.539980129
29179,"Reynolds County, Missouri",NA,2023,6058,2,6056,0.033014196
29181,"Ripley County, Missouri",NA,2023,10755,64,10691,0.59507206
29183,"St. Charles County, Missouri",NA,2023,409830,7944,401886,1.938364688
29185,"St. Clair County, Missouri",NA,2023,9451,63,9388,0.666596127
29186,"Ste. Genevieve County, Missouri",NA,2023,18551,18,18533,0.09702981
29187,"St. Francois County, Missouri",NA,2023,66864,400,66464,0.598229241
29189,"St. Louis County, Missouri",NA,2023,996618,35313,961305,3.543283384
29195,"Saline County, Missouri",NA,2023,23177,965,22212,4.163610476
29197,"Schuyler County, Missouri",NA,2023,4044,10,4034,0.247279921
29199,"Scotland County, Missouri",NA,2023,4698,47,4651,1.000425713
29201,"Scott County, Missouri",NA,2023,37967,128,37839,0.33713488
29203,"Shannon County, Missouri",NA,2023,7137,11,7126,0.154126384
29205,"Shelby County, Missouri",NA,2023,6011,47,5964,0.78189985
29207,"Stoddard County, Missouri",NA,2023,28547,59,28488,0.206676709
29209,"Stone County, Missouri",NA,2023,31697,210,31487,0.662523267
29211,"Sullivan County, Missouri",NA,2023,5903,313,5590,5.302388616
29213,"Taney County, Missouri",NA,2023,56382,727,55655,1.289418609
29215,"Texas County, Missouri",NA,2023,24956,31,24925,0.124218625
29217,"Vernon County, Missouri",NA,2023,19713,242,19471,1.227616294
29219,"Warren County, Missouri",NA,2023,36467,156,36311,0.427784024
29221,"Washington County, Missouri",NA,2023,23483,77,23406,0.327896776
29223,"Wayne County, Missouri",NA,2023,10942,3,10939,0.027417291
29225,"Webster County, Missouri",NA,2023,39868,182,39686,0.456506471
29227,"Worth County, Missouri",NA,2023,1956,0,1956,0
29229,"Wright County, Missouri",NA,2023,18722,23,18699,0.122850123
29510,"St. Louis city, Missouri",NA,2023,293109,11379,281730,3.882173526
30001,"Beaverhead County, Montana",NA,2023,9590,61,9529,0.636079249
30003,"Big Horn County, Montana",NA,2023,12963,29,12934,0.223713647
30005,"Blaine County, Montana",NA,2023,6997,38,6959,0.543089896
30007,"Broadwater County, Montana",NA,2023,7310,52,7258,0.711354309
30009,"Carbon County, Montana",NA,2023,10877,91,10786,0.836627747
30011,"Carter County, Montana",NA,2023,1361,3,1358,0.220426157
30013,"Cascade County, Montana",NA,2023,84601,505,84096,0.596919658
30015,"Chouteau County, Montana",NA,2023,5888,28,5860,0.475543478
30017,"Custer County, Montana",NA,2023,11938,75,11863,0.628245937
30019,"Daniels County, Montana",NA,2023,1524,8,1516,0.524934383
30021,"Dawson County, Montana",NA,2023,8874,38,8836,0.428217264
30023,"Deer Lodge County, Montana",NA,2023,9512,21,9491,0.220773759
30025,"Fallon County, Montana",NA,2023,2817,0,2817,0
30027,"Fergus County, Montana",NA,2023,11581,44,11537,0.379932648
30029,"Flathead County, Montana",NA,2023,108445,1216,107229,1.121305731
30031,"Gallatin County, Montana",NA,2023,122194,2481,119713,2.030377924
30033,"Garfield County, Montana",NA,2023,938,0,938,0
30035,"Glacier County, Montana",NA,2023,13713,57,13656,0.415663968
30037,"Golden Valley County, Montana",NA,2023,840,0,840,0
30039,"Granite County, Montana",NA,2023,3419,47,3372,1.374670956
30041,"Hill County, Montana",NA,2023,16260,50,16210,0.307503075
30043,"Jefferson County, Montana",NA,2023,12501,120,12381,0.959923206
30045,"Judith Basin County, Montana",NA,2023,2053,34,2019,1.656113005
30047,"Lake County, Montana",NA,2023,32073,349,31724,1.088142675
30049,"Lewis and Clark County, Montana",NA,2023,72580,527,72053,0.726095343
30051,"Liberty County, Montana",NA,2023,1968,20,1948,1.016260163
30053,"Lincoln County, Montana",NA,2023,20656,334,20322,1.616963594
30055,"McCone County, Montana",NA,2023,1818,0,1818,0
30057,"Madison County, Montana",NA,2023,8975,99,8876,1.103064067
30059,"Meagher County, Montana",NA,2023,1979,22,1957,1.111672562
30061,"Mineral County, Montana",NA,2023,4796,18,4778,0.375312761
30063,"Missoula County, Montana",NA,2023,119639,1567,118072,1.309773569
30065,"Musselshell County, Montana",NA,2023,5068,62,5006,1.223362273
30067,"Park County, Montana",NA,2023,17484,131,17353,0.749256463
30069,"Petroleum County, Montana",NA,2023,401,0,401,0
30071,"Phillips County, Montana",NA,2023,4224,44,4180,1.041666667
30073,"Pondera County, Montana",NA,2023,6012,48,5964,0.798403194
30075,"Powder River County, Montana",NA,2023,1762,35,1727,1.986379115
30077,"Powell County, Montana",NA,2023,7029,27,7002,0.384122919
30079,"Prairie County, Montana",NA,2023,1251,49,1202,3.916866507
30081,"Ravalli County, Montana",NA,2023,45807,395,45412,0.86231362
30083,"Richland County, Montana",NA,2023,11329,229,11100,2.021361109
30085,"Roosevelt County, Montana",NA,2023,10665,43,10622,0.403187998
30087,"Rosebud County, Montana",NA,2023,8236,61,8175,0.740650801
30089,"Sanders County, Montana",NA,2023,12936,56,12880,0.432900433
30091,"Sheridan County, Montana",NA,2023,3677,44,3633,1.196627686
30093,"Silver Bow County, Montana",NA,2023,35589,281,35308,0.789569811
30095,"Stillwater County, Montana",NA,2023,9052,22,9030,0.243040212
30097,"Sweet Grass County, Montana",NA,2023,3713,5,3708,0.134661998
30099,"Teton County, Montana",NA,2023,6291,11,6280,0.174852965
30101,"Toole County, Montana",NA,2023,5028,80,4948,1.591089897
30103,"Treasure County, Montana",NA,2023,761,15,746,1.97109067
30105,"Valley County, Montana",NA,2023,7540,43,7497,0.570291777
30107,"Wheatland County, Montana",NA,2023,2049,2,2047,0.09760859
30109,"Wibaux County, Montana",NA,2023,1148,0,1148,0
30111,"Yellowstone County, Montana",NA,2023,167340,1510,165830,0.902354488
31001,"Adams County, Nebraska",NA,2023,31034,1196,29838,3.853837726
31003,"Antelope County, Nebraska",NA,2023,6302,110,6192,1.745477626
31005,"Arthur County, Nebraska",NA,2023,540,3,537,0.555555556
31007,"Banner County, Nebraska",NA,2023,657,31,626,4.718417047
31009,"Blaine County, Nebraska",NA,2023,385,0,385,0
31011,"Boone County, Nebraska",NA,2023,5366,53,5313,0.987700335
31013,"Box Butte County, Nebraska",NA,2023,10754,572,10182,5.318951088
31015,"Boyd County, Nebraska",NA,2023,1704,32,1672,1.877934272
31017,"Brown County, Nebraska",NA,2023,2739,106,2633,3.870025557
31019,"Buffalo County, Nebraska",NA,2023,50323,1272,49051,2.527671244
31021,"Burt County, Nebraska",NA,2023,6730,9,6721,0.133729569
31023,"Butler County, Nebraska",NA,2023,8413,151,8262,1.794841317
31025,"Cass County, Nebraska",NA,2023,26963,145,26818,0.537773987
31027,"Cedar County, Nebraska",NA,2023,8344,51,8293,0.611217641
31029,"Chase County, Nebraska",NA,2023,3639,221,3418,6.073097005
31031,"Cherry County, Nebraska",NA,2023,5468,53,5415,0.969275786
31033,"Cheyenne County, Nebraska",NA,2023,9478,77,9401,0.812407681
31035,"Clay County, Nebraska",NA,2023,6084,74,6010,1.216305062
31037,"Colfax County, Nebraska",NA,2023,10541,2216,8325,21.02267337
31039,"Cuming County, Nebraska",NA,2023,8976,512,8464,5.704099822
31041,"Custer County, Nebraska",NA,2023,10544,157,10387,1.488998483
31043,"Dakota County, Nebraska",NA,2023,21331,2262,19069,10.60428484
31045,"Dawes County, Nebraska",NA,2023,8212,8,8204,0.097418412
31047,"Dawson County, Nebraska",NA,2023,24020,2755,21265,11.46960866
31049,"Deuel County, Nebraska",NA,2023,1865,7,1858,0.375335121
31051,"Dixon County, Nebraska",NA,2023,5561,351,5210,6.311814422
31053,"Dodge County, Nebraska",NA,2023,37146,1589,35557,4.277714963
31055,"Douglas County, Nebraska",NA,2023,585461,37331,548130,6.376342745
31057,"Dundy County, Nebraska",NA,2023,1811,11,1800,0.607399227
31059,"Fillmore County, Nebraska",NA,2023,5551,16,5535,0.288236354
31061,"Franklin County, Nebraska",NA,2023,2868,2,2866,0.069735007
31063,"Frontier County, Nebraska",NA,2023,2562,31,2531,1.209992194
31065,"Furnas County, Nebraska",NA,2023,4605,54,4551,1.172638436
31067,"Gage County, Nebraska",NA,2023,21646,64,21582,0.295666636
31069,"Garden County, Nebraska",NA,2023,1620,0,1620,0
31071,"Garfield County, Nebraska",NA,2023,1797,0,1797,0
31073,"Gosper County, Nebraska",NA,2023,1929,24,1905,1.244167963
31075,"Grant County, Nebraska",NA,2023,695,15,680,2.158273381
31077,"Greeley County, Nebraska",NA,2023,2211,7,2204,0.316598824
31079,"Hall County, Nebraska",NA,2023,62431,6212,56219,9.950185004
31081,"Hamilton County, Nebraska",NA,2023,9438,64,9374,0.678109769
31083,"Harlan County, Nebraska",NA,2023,3006,49,2957,1.630073187
31085,"Hayes County, Nebraska",NA,2023,854,32,822,3.7470726
31087,"Hitchcock County, Nebraska",NA,2023,2601,7,2594,0.269127259
31089,"Holt County, Nebraska",NA,2023,10093,206,9887,2.041018528
31091,"Hooker County, Nebraska",NA,2023,613,0,613,0
31093,"Howard County, Nebraska",NA,2023,6492,94,6398,1.447935921
31095,"Jefferson County, Nebraska",NA,2023,7155,68,7087,0.950384347
31097,"Johnson County, Nebraska",NA,2023,5263,123,5140,2.337070112
31099,"Kearney County, Nebraska",NA,2023,6697,12,6685,0.17918471
31101,"Keith County, Nebraska",NA,2023,8239,66,8173,0.801068091
31103,"Keya Paha County, Nebraska",NA,2023,939,27,912,2.875399361
31105,"Kimball County, Nebraska",NA,2023,3348,62,3286,1.851851852
31107,"Knox County, Nebraska",NA,2023,8362,35,8327,0.418560153
31109,"Lancaster County, Nebraska",NA,2023,323673,13305,310368,4.110630173
31111,"Lincoln County, Nebraska",NA,2023,34122,419,33703,1.227946779
31113,"Logan County, Nebraska",NA,2023,812,4,808,0.492610837
31115,"Loup County, Nebraska",NA,2023,564,0,564,0
31117,"McPherson County, Nebraska",NA,2023,463,10,453,2.159827214
31119,"Madison County, Nebraska",NA,2023,35535,1627,33908,4.578584494
31121,"Merrick County, Nebraska",NA,2023,7696,69,7627,0.896569647
31123,"Morrill County, Nebraska",NA,2023,4544,103,4441,2.266725352
31125,"Nance County, Nebraska",NA,2023,3342,0,3342,0
31127,"Nemaha County, Nebraska",NA,2023,7035,6,7029,0.085287846
31129,"Nuckolls County, Nebraska",NA,2023,4089,22,4067,0.538028858
31131,"Otoe County, Nebraska",NA,2023,16075,804,15271,5.00155521
31133,"Pawnee County, Nebraska",NA,2023,2539,9,2530,0.354470264
31135,"Perkins County, Nebraska",NA,2023,2835,73,2762,2.574955908
31137,"Phelps County, Nebraska",NA,2023,8983,169,8814,1.881331404
31139,"Pierce County, Nebraska",NA,2023,7312,78,7234,1.066739606
31141,"Platte County, Nebraska",NA,2023,34358,2401,31957,6.988183247
31143,"Polk County, Nebraska",NA,2023,5209,69,5140,1.324630447
31145,"Red Willow County, Nebraska",NA,2023,10611,69,10542,0.650268589
31147,"Richardson County, Nebraska",NA,2023,7797,48,7749,0.615621393
31149,"Rock County, Nebraska",NA,2023,1335,2,1333,0.149812734
31151,"Saline County, Nebraska",NA,2023,14642,1627,13015,11.11186996
31153,"Sarpy County, Nebraska",NA,2023,194051,5327,188724,2.745154624
31155,"Saunders County, Nebraska",NA,2023,22761,127,22634,0.55797197
31157,"Scotts Bluff County, Nebraska",NA,2023,35937,852,35085,2.370815594
31159,"Seward County, Nebraska",NA,2023,17636,45,17591,0.2551599
31161,"Sheridan County, Nebraska",NA,2023,5058,41,5017,0.810597074
31163,"Sherman County, Nebraska",NA,2023,2974,0,2974,0
31165,"Sioux County, Nebraska",NA,2023,1197,17,1180,1.42021721
31167,"Stanton County, Nebraska",NA,2023,5835,44,5791,0.754070266
31169,"Thayer County, Nebraska",NA,2023,4938,6,4932,0.121506683
31171,"Thomas County, Nebraska",NA,2023,626,0,626,0
31173,"Thurston County, Nebraska",NA,2023,6666,47,6619,0.705070507
31175,"Valley County, Nebraska",NA,2023,4094,48,4046,1.172447484
31177,"Washington County, Nebraska",NA,2023,20989,137,20852,0.652722855
31179,"Wayne County, Nebraska",NA,2023,9786,371,9415,3.791130186
31181,"Webster County, Nebraska",NA,2023,3385,5,3380,0.147710487
31183,"Wheeler County, Nebraska",NA,2023,785,11,774,1.401273885
31185,"York County, Nebraska",NA,2023,14231,232,13999,1.630243834
32001,"Churchill County, Nevada",NA,2023,25614,418,25196,1.631920044
32003,"Clark County, Nevada",NA,2023,2293764,229439,2064325,10.00272914
32005,"Douglas County, Nevada",NA,2023,49624,968,48656,1.950669031
32007,"Elko County, Nevada",NA,2023,53852,2383,51469,4.42509099
32009,"Esmeralda County, Nevada",NA,2023,962,36,926,3.742203742
32011,"Eureka County, Nevada",NA,2023,1660,8,1652,0.481927711
32013,"Humboldt County, Nevada",NA,2023,17299,744,16555,4.300826637
32015,"Lander County, Nevada",NA,2023,5745,127,5618,2.210617929
32017,"Lincoln County, Nevada",NA,2023,4452,23,4429,0.516621743
32019,"Lyon County, Nevada",NA,2023,60630,2194,58436,3.618670625
32021,"Mineral County, Nevada",NA,2023,4557,15,4542,0.329163924
32023,"Nye County, Nevada",NA,2023,53207,1725,51482,3.242054617
32027,"Pershing County, Nevada",NA,2023,6505,363,6142,5.580322829
32029,"Storey County, Nevada",NA,2023,4139,102,4037,2.464363373
32031,"Washoe County, Nevada",NA,2023,491770,36504,455266,7.422982288
32033,"White Pine County, Nevada",NA,2023,8856,117,8739,1.321138211
32510,"Carson City, Nevada",NA,2023,58364,3805,54559,6.519429785
33001,"Belknap County, New Hampshire",NA,2023,64300,671,63629,1.043545879
33003,"Carroll County, New Hampshire",NA,2023,51259,268,50991,0.522835014
33005,"Cheshire County, New Hampshire",NA,2023,76945,918,76027,1.193059978
33007,"Coos County, New Hampshire",NA,2023,31386,413,30973,1.315873319
33009,"Grafton County, New Hampshire",NA,2023,91759,2824,88935,3.077627263
33011,"Hillsborough County, New Hampshire",NA,2023,424732,19088,405644,4.494128062
33013,"Merrimack County, New Hampshire",NA,2023,155018,2399,152619,1.547562219
33015,"Rockingham County, New Hampshire",NA,2023,317163,5623,311540,1.772905415
33017,"Strafford County, New Hampshire",NA,2023,131743,2034,129709,1.543915047
33019,"Sullivan County, New Hampshire",NA,2023,43529,248,43281,0.569735119
34001,"Atlantic County, New Jersey",NA,2023,274704,19226,255478,6.998805988
34003,"Bergen County, New Jersey",NA,2023,954717,100840,853877,10.56229228
34005,"Burlington County, New Jersey",NA,2023,464226,17193,447033,3.70358403
34007,"Camden County, New Jersey",NA,2023,524042,28308,495734,5.401857103
34009,"Cape May County, New Jersey",NA,2023,95236,2436,92800,2.557856273
34011,"Cumberland County, New Jersey",NA,2023,152915,12498,140417,8.1731681
34013,"Essex County, New Jersey",NA,2023,854130,122529,731601,14.34547434
34015,"Gloucester County, New Jersey",NA,2023,304504,6543,297961,2.148740246
34017,"Hudson County, New Jersey",NA,2023,710478,146865,563613,20.67129454
34019,"Hunterdon County, New Jersey",NA,2023,129448,5196,124252,4.013966998
34021,"Mercer County, New Jersey",NA,2023,383286,51211,332075,13.3610411
34023,"Middlesex County, New Jersey",NA,2023,861535,125892,735643,14.612523
34025,"Monmouth County, New Jersey",NA,2023,643615,30129,613486,4.681214701
34027,"Morris County, New Jersey",NA,2023,510375,39270,471105,7.694342395
34029,"Ocean County, New Jersey",NA,2023,646434,18730,627704,2.897434231
34031,"Passaic County, New Jersey",NA,2023,518289,75825,442464,14.62986866
34033,"Salem County, New Jersey",NA,2023,64973,804,64169,1.237437089
34035,"Somerset County, New Jersey",NA,2023,346203,37977,308226,10.96957565
34037,"Sussex County, New Jersey",NA,2023,145117,3461,141656,2.384972126
34039,"Union County, New Jersey",NA,2023,572549,91600,480949,15.99863068
34041,"Warren County, New Jersey",NA,2023,110238,4122,106116,3.739182496
35001,"Bernalillo County, New Mexico",NA,2023,674357,34783,639574,5.157950462
35003,"Catron County, New Mexico",NA,2023,3685,92,3593,2.49660787
35005,"Chaves County, New Mexico",NA,2023,64446,3709,60737,5.755205909
35006,"Cibola County, New Mexico",NA,2023,27059,371,26688,1.371078015
35007,"Colfax County, New Mexico",NA,2023,12336,257,12079,2.083333333
35009,"Curry County, New Mexico",NA,2023,47932,2658,45274,5.545355921
35011,"De Baca County, New Mexico",NA,2023,1580,0,1580,0
35013,"Doña Ana County, New Mexico",NA,2023,221665,16654,205011,7.513139197
35015,"Eddy County, New Mexico",NA,2023,61114,2562,58552,4.192165461
35017,"Grant County, New Mexico",NA,2023,27856,567,27289,2.035468122
35019,"Guadalupe County, New Mexico",NA,2023,4379,185,4194,4.224708838
35021,"Harding County, New Mexico",NA,2023,748,24,724,3.20855615
35023,"Hidalgo County, New Mexico",NA,2023,4097,179,3918,4.369050525
35025,"Lea County, New Mexico",NA,2023,73154,10100,63054,13.80649042
35027,"Lincoln County, New Mexico",NA,2023,20227,600,19627,2.96633213
35028,"Los Alamos County, New Mexico",NA,2023,19374,880,18494,4.542169918
35029,"Luna County, New Mexico",NA,2023,25420,2461,22959,9.681353265
35031,"McKinley County, New Mexico",NA,2023,71172,964,70208,1.354465239
35033,"Mora County, New Mexico",NA,2023,4176,4,4172,0.095785441
35035,"Otero County, New Mexico",NA,2023,68235,4127,64108,6.048215725
35037,"Quay County, New Mexico",NA,2023,8616,95,8521,1.102599814
35039,"Rio Arriba County, New Mexico",NA,2023,40165,1670,38495,4.157848873
35041,"Roosevelt County, New Mexico",NA,2023,19002,952,18050,5.009998947
35043,"Sandoval County, New Mexico",NA,2023,151538,3657,147881,2.413256081
35045,"San Juan County, New Mexico",NA,2023,121178,2066,119112,1.704929938
35047,"San Miguel County, New Mexico",NA,2023,27036,437,26599,1.616363367
35049,"Santa Fe County, New Mexico",NA,2023,155175,10739,144436,6.920573546
35051,"Sierra County, New Mexico",NA,2023,11511,791,10720,6.871687951
35053,"Socorro County, New Mexico",NA,2023,16308,629,15679,3.857002698
35055,"Taos County, New Mexico",NA,2023,34516,1339,33177,3.879360297
35057,"Torrance County, New Mexico",NA,2023,15290,433,14857,2.831916285
35059,"Union County, New Mexico",NA,2023,4039,81,3958,2.005446893
35061,"Valencia County, New Mexico",NA,2023,77382,3414,73968,4.411878731
36001,"Albany County, New York",NA,2023,315374,16033,299341,5.08380526
36003,"Allegany County, New York",NA,2023,47027,487,46540,1.035575308
36005,"Bronx County, New York",NA,2023,1419250,224980,1194270,15.85203453
36007,"Broome County, New York",NA,2023,197738,6503,191235,3.288695142
36009,"Cattaraugus County, New York",NA,2023,76479,443,76036,0.579243975
36011,"Cayuga County, New York",NA,2023,75464,710,74754,0.940845966
36013,"Chautauqua County, New York",NA,2023,126329,1359,124970,1.075762493
36015,"Chemung County, New York",NA,2023,82805,1399,81406,1.689511503
36017,"Chenango County, New York",NA,2023,46685,551,46134,1.180250616
36019,"Clinton County, New York",NA,2023,78961,2098,76863,2.65700789
36021,"Columbia County, New York",NA,2023,61245,1726,59519,2.81818924
36023,"Cortland County, New York",NA,2023,46401,371,46030,0.799551734
36025,"Delaware County, New York",NA,2023,44551,543,44008,1.21882786
36027,"Dutchess County, New York",NA,2023,297144,14576,282568,4.905365749
36029,"Erie County, New York",NA,2023,950044,29028,921016,3.055437432
36031,"Essex County, New York",NA,2023,37077,674,36403,1.817838552
36033,"Franklin County, New York",NA,2023,47066,540,46526,1.147325033
36035,"Fulton County, New York",NA,2023,52787,384,52403,0.727451835
36037,"Genesee County, New York",NA,2023,57943,785,57158,1.354779697
36039,"Greene County, New York",NA,2023,47554,562,46992,1.181814358
36041,"Hamilton County, New York",NA,2023,5102,11,5091,0.215601725
36043,"Herkimer County, New York",NA,2023,59932,577,59355,0.962757792
36045,"Jefferson County, New York",NA,2023,116130,2094,114036,1.80315164
36047,"Kings County, New York",NA,2023,2646306,353424,2292882,13.3553716
36049,"Lewis County, New York",NA,2023,26618,172,26446,0.646179277
36051,"Livingston County, New York",NA,2023,61588,1047,60541,1.700006495
36053,"Madison County, New York",NA,2023,67572,855,66717,1.265316995
36055,"Monroe County, New York",NA,2023,754068,21942,732126,2.909817152
36057,"Montgomery County, New York",NA,2023,49461,594,48867,1.2009462
36059,"Nassau County, New York",NA,2023,1388138,95293,1292845,6.864807389
36061,"New York County, New York",NA,2023,1627788,210500,1417288,12.93165941
36063,"Niagara County, New York",NA,2023,211341,3269,208072,1.546789312
36065,"Oneida County, New York",NA,2023,229645,8125,221520,3.538069629
36067,"Onondaga County, New York",NA,2023,471611,15815,455796,3.353399306
36069,"Ontario County, New York",NA,2023,112405,1834,110571,1.631600018
36071,"Orange County, New York",NA,2023,403840,22891,380949,5.668333994
36073,"Orleans County, New York",NA,2023,39686,583,39103,1.4690319
36075,"Oswego County, New York",NA,2023,117945,769,117176,0.651998813
36077,"Otsego County, New York",NA,2023,59738,1163,58575,1.946834511
36079,"Putnam County, New York",NA,2023,97988,4595,93393,4.689349716
36081,"Queens County, New York",NA,2023,2330124,449255,1880869,19.2803044
36083,"Rensselaer County, New York",NA,2023,160341,4587,155754,2.860777967
36085,"Richmond County, New York",NA,2023,492734,38981,453753,7.911165051
36087,"Rockland County, New York",NA,2023,338936,30275,308661,8.932364812
36089,"St. Lawrence County, New York",NA,2023,107796,1687,106109,1.564993135
36091,"Saratoga County, New York",NA,2023,237075,5212,231863,2.198460403
36093,"Schenectady County, New York",NA,2023,159603,5825,153778,3.64968077
36095,"Schoharie County, New York",NA,2023,29979,246,29733,0.820574402
36097,"Schuyler County, New York",NA,2023,17749,164,17585,0.923995718
36099,"Seneca County, New York",NA,2023,33125,431,32694,1.301132075
36101,"Steuben County, New York",NA,2023,93034,1290,91744,1.386589849
36103,"Suffolk County, New York",NA,2023,1525680,101309,1424371,6.640252215
36105,"Sullivan County, New York",NA,2023,79147,4308,74839,5.443036375
36107,"Tioga County, New York",NA,2023,48106,455,47651,0.945827963
36109,"Tompkins County, New York",NA,2023,102879,8420,94459,8.184371932
36111,"Ulster County, New York",NA,2023,182109,5913,176196,3.246956493
36113,"Warren County, New York",NA,2023,65560,933,64627,1.423123856
36115,"Washington County, New York",NA,2023,60883,1074,59809,1.764039223
36117,"Wayne County, New York",NA,2023,91128,673,90455,0.73852164
36119,"Westchester County, New York",NA,2023,996888,101905,894983,10.22231183
36121,"Wyoming County, New York",NA,2023,39980,442,39538,1.105552776
36123,"Yates County, New York",NA,2023,24637,89,24548,0.361245281
37001,"Alamance County, North Carolina",NA,2023,174286,9796,164490,5.620646524
37003,"Alexander County, North Carolina",NA,2023,36440,312,36128,0.856201976
37005,"Alleghany County, North Carolina",NA,2023,11075,344,10731,3.106094808
37007,"Anson County, North Carolina",NA,2023,21903,420,21483,1.917545542
37009,"Ashe County, North Carolina",NA,2023,26831,385,26446,1.434907383
37011,"Avery County, North Carolina",NA,2023,17643,488,17155,2.765969506
37013,"Beaufort County, North Carolina",NA,2023,44597,1043,43554,2.338722336
37015,"Bertie County, North Carolina",NA,2023,17482,250,17232,1.430042329
37017,"Bladen County, North Carolina",NA,2023,29591,615,28976,2.078334629
37019,"Brunswick County, North Carolina",NA,2023,145889,2003,143886,1.372961635
37021,"Buncombe County, North Carolina",NA,2023,271790,10702,261088,3.937598881
37023,"Burke County, North Carolina",NA,2023,87863,2422,85441,2.756564197
37025,"Cabarrus County, North Carolina",NA,2023,231262,12362,218900,5.345452344
37027,"Caldwell County, North Carolina",NA,2023,80618,1846,78772,2.289811208
37029,"Camden County, North Carolina",NA,2023,10743,34,10709,0.316485153
37031,"Carteret County, North Carolina",NA,2023,68652,963,67689,1.402726796
37033,"Caswell County, North Carolina",NA,2023,22689,503,22186,2.216933316
37035,"Catawba County, North Carolina",NA,2023,162051,6102,155949,3.765481237
37037,"Chatham County, North Carolina",NA,2023,78319,5470,72849,6.984256694
37039,"Cherokee County, North Carolina",NA,2023,29197,193,29004,0.661026818
37041,"Chowan County, North Carolina",NA,2023,13814,141,13673,1.020703634
37043,"Clay County, North Carolina",NA,2023,11391,121,11270,1.062242121
37045,"Cleveland County, North Carolina",NA,2023,100170,1374,98796,1.371668164
37047,"Columbus County, North Carolina",NA,2023,50453,722,49731,1.431034824
37049,"Craven County, North Carolina",NA,2023,101074,1661,99413,1.643350417
37051,"Cumberland County, North Carolina",NA,2023,336749,9823,326926,2.917009405
37053,"Currituck County, North Carolina",NA,2023,29612,307,29305,1.036741861
37055,"Dare County, North Carolina",NA,2023,37534,1131,36403,3.01326797
37057,"Davidson County, North Carolina",NA,2023,171063,5104,165959,2.983696065
37059,"Davie County, North Carolina",NA,2023,43526,1295,42231,2.975233194
37061,"Duplin County, North Carolina",NA,2023,49053,4488,44565,9.149287505
37063,"Durham County, North Carolina",NA,2023,329405,31425,297980,9.539928052
37065,"Edgecombe County, North Carolina",NA,2023,48777,1024,47753,2.099350104
37067,"Forsyth County, North Carolina",NA,2023,386740,21915,364825,5.666597714
37069,"Franklin County, North Carolina",NA,2023,71962,2542,69420,3.532419888
37071,"Gaston County, North Carolina",NA,2023,231485,7320,224165,3.162191935
37073,"Gates County, North Carolina",NA,2023,10437,59,10378,0.565296541
37075,"Graham County, North Carolina",NA,2023,8041,131,7910,1.629150603
37077,"Granville County, North Carolina",NA,2023,61439,2482,58957,4.039779293
37079,"Greene County, North Carolina",NA,2023,20421,1130,19291,5.533519416
37081,"Guilford County, North Carolina",NA,2023,542987,31866,511121,5.868648789
37083,"Halifax County, North Carolina",NA,2023,48219,860,47359,1.783529314
37085,"Harnett County, North Carolina",NA,2023,136503,4980,131523,3.648271467
37087,"Haywood County, North Carolina",NA,2023,62432,719,61713,1.151652998
37089,"Henderson County, North Carolina",NA,2023,117387,5141,112246,4.379530953
37091,"Hertford County, North Carolina",NA,2023,20492,690,19802,3.367167675
37093,"Hoke County, North Carolina",NA,2023,53102,2039,51063,3.839780046
37095,"Hyde County, North Carolina",NA,2023,4625,93,4532,2.010810811
37097,"Iredell County, North Carolina",NA,2023,191800,7692,184108,4.010427529
37099,"Jackson County, North Carolina",NA,2023,43089,1382,41707,3.207315092
37101,"Johnston County, North Carolina",NA,2023,226623,12746,213877,5.624318803
37103,"Jones County, North Carolina",NA,2023,9245,117,9128,1.265548945
37105,"Lee County, North Carolina",NA,2023,64565,4753,59812,7.361573608
37107,"Lenoir County, North Carolina",NA,2023,54917,1513,53404,2.755066737
37109,"Lincoln County, North Carolina",NA,2023,90359,2472,87887,2.735754048
37111,"McDowell County, North Carolina",NA,2023,44679,1265,43414,2.831307773
37113,"Macon County, North Carolina",NA,2023,37533,1198,36335,3.191857832
37115,"Madison County, North Carolina",NA,2023,21640,136,21504,0.628465804
37117,"Martin County, North Carolina",NA,2023,21773,104,21669,0.477655812
37119,"Mecklenburg County, North Carolina",NA,2023,1130906,115164,1015742,10.18333973
37121,"Mitchell County, North Carolina",NA,2023,14973,264,14709,1.763173713
37123,"Montgomery County, North Carolina",NA,2023,25874,1373,24501,5.306485275
37125,"Moore County, North Carolina",NA,2023,102840,2482,100358,2.413457799
37127,"Nash County, North Carolina",NA,2023,95451,2152,93299,2.254559931
37129,"New Hanover County, North Carolina",NA,2023,231214,8202,223012,3.547363049
37131,"Northampton County, North Carolina",NA,2023,17212,94,17118,0.546130607
37133,"Onslow County, North Carolina",NA,2023,208537,3138,205399,1.504768938
37135,"Orange County, North Carolina",NA,2023,147292,9929,137363,6.741031421
37137,"Pamlico County, North Carolina",NA,2023,12315,198,12117,1.607795371
37139,"Pasquotank County, North Carolina",NA,2023,40830,423,40407,1.036002939
37141,"Pender County, North Carolina",NA,2023,63475,1722,61753,2.712879086
37143,"Perquimans County, North Carolina",NA,2023,13146,68,13078,0.51726761
37145,"Person County, North Carolina",NA,2023,39275,623,38652,1.586250796
37147,"Pitt County, North Carolina",NA,2023,172279,5679,166600,3.296397123
37149,"Polk County, North Carolina",NA,2023,19689,364,19325,1.848748032
37151,"Randolph County, North Carolina",NA,2023,145322,6792,138530,4.673758963
37153,"Richmond County, North Carolina",NA,2023,42818,669,42149,1.562427017
37155,"Robeson County, North Carolina",NA,2023,116858,4506,112352,3.855961937
37157,"Rockingham County, North Carolina",NA,2023,91585,1922,89663,2.098596932
37159,"Rowan County, North Carolina",NA,2023,148487,6245,142242,4.205755386
37161,"Rutherford County, North Carolina",NA,2023,64850,1007,63843,1.552814187
37163,"Sampson County, North Carolina",NA,2023,59245,4838,54407,8.166089965
37165,"Scotland County, North Carolina",NA,2023,34353,498,33855,1.449655052
37167,"Stanly County, North Carolina",NA,2023,63557,1319,62238,2.075302484
37169,"Stokes County, North Carolina",NA,2023,44889,189,44700,0.421038562
37171,"Surry County, North Carolina",NA,2023,71407,2824,68583,3.954794348
37173,"Swain County, North Carolina",NA,2023,14065,97,13968,0.689655172
37175,"Transylvania County, North Carolina",NA,2023,33243,739,32504,2.223024396
37177,"Tyrrell County, North Carolina",NA,2023,3376,222,3154,6.575829384
37179,"Union County, North Carolina",NA,2023,244975,14250,230725,5.816920094
37181,"Vance County, North Carolina",NA,2023,42361,1615,40746,3.812469016
37183,"Wake County, North Carolina",NA,2023,1151009,89378,1061631,7.765186893
37185,"Warren County, North Carolina",NA,2023,18751,352,18399,1.877233214
37187,"Washington County, North Carolina",NA,2023,10905,64,10841,0.586886749
37189,"Watauga County, North Carolina",NA,2023,54607,1314,53293,2.406284909
37191,"Wayne County, North Carolina",NA,2023,117606,5586,112020,4.749757665
37193,"Wilkes County, North Carolina",NA,2023,65983,1554,64429,2.355152085
37195,"Wilson County, North Carolina",NA,2023,78648,2846,75802,3.618655274
37197,"Yadkin County, North Carolina",NA,2023,37419,1482,35937,3.960554798
37199,"Yancey County, North Carolina",NA,2023,18676,403,18273,2.157849647
38001,"Adams County, North Dakota",NA,2023,2179,58,2121,2.661771455
38003,"Barnes County, North Dakota",NA,2023,10794,211,10583,1.954789698
38005,"Benson County, North Dakota",NA,2023,5861,35,5826,0.597167719
38007,"Billings County, North Dakota",NA,2023,948,11,937,1.160337553
38009,"Bottineau County, North Dakota",NA,2023,6390,144,6246,2.253521127
38011,"Bowman County, North Dakota",NA,2023,2935,17,2918,0.579216354
38013,"Burke County, North Dakota",NA,2023,2163,27,2136,1.248266297
38015,"Burleigh County, North Dakota",NA,2023,98986,1820,97166,1.838643849
38017,"Cass County, North Dakota",NA,2023,189286,8869,180417,4.685502362
38019,"Cavalier County, North Dakota",NA,2023,3663,36,3627,0.982800983
38021,"Dickey County, North Dakota",NA,2023,4959,125,4834,2.52066949
38023,"Divide County, North Dakota",NA,2023,2174,22,2152,1.011959522
38025,"Dunn County, North Dakota",NA,2023,4043,89,3954,2.201335642
38027,"Eddy County, North Dakota",NA,2023,2319,3,2316,0.129366106
38029,"Emmons County, North Dakota",NA,2023,3269,0,3269,0
38031,"Foster County, North Dakota",NA,2023,3372,45,3327,1.334519573
38033,"Golden Valley County, North Dakota",NA,2023,1679,9,1670,0.536033353
38035,"Grand Forks County, North Dakota",NA,2023,72764,2674,70090,3.674894178
38037,"Grant County, North Dakota",NA,2023,2276,54,2222,2.37258348
38039,"Griggs County, North Dakota",NA,2023,2340,10,2330,0.427350427
38041,"Hettinger County, North Dakota",NA,2023,2453,0,2453,0
38043,"Kidder County, North Dakota",NA,2023,2374,5,2369,0.210614996
38045,"LaMoure County, North Dakota",NA,2023,4107,7,4100,0.170440711
38047,"Logan County, North Dakota",NA,2023,1848,3,1845,0.162337662
38049,"McHenry County, North Dakota",NA,2023,5264,58,5206,1.101823708
38051,"McIntosh County, North Dakota",NA,2023,2512,83,2429,3.304140127
38053,"McKenzie County, North Dakota",NA,2023,14280,282,13998,1.974789916
38055,"McLean County, North Dakota",NA,2023,9807,118,9689,1.203222188
38057,"Mercer County, North Dakota",NA,2023,8341,35,8306,0.419613955
38059,"Morton County, North Dakota",NA,2023,33479,129,33350,0.385316168
38061,"Mountrail County, North Dakota",NA,2023,9567,140,9427,1.463363646
38063,"Nelson County, North Dakota",NA,2023,3015,71,2944,2.354892206
38065,"Oliver County, North Dakota",NA,2023,1821,0,1821,0
38067,"Pembina County, North Dakota",NA,2023,6787,119,6668,1.753351996
38069,"Pierce County, North Dakota",NA,2023,3961,6,3955,0.1514769
38071,"Ramsey County, North Dakota",NA,2023,11563,111,11452,0.959958488
38073,"Ransom County, North Dakota",NA,2023,5662,50,5612,0.883080184
38075,"Renville County, North Dakota",NA,2023,2277,55,2222,2.415458937
38077,"Richland County, North Dakota",NA,2023,16550,87,16463,0.525679758
38079,"Rolette County, North Dakota",NA,2023,12065,43,12022,0.356402818
38081,"Sargent County, North Dakota",NA,2023,3822,49,3773,1.282051282
38083,"Sheridan County, North Dakota",NA,2023,1327,12,1315,0.904295403
38085,"Sioux County, North Dakota",NA,2023,3789,2,3787,0.052784376
38087,"Slope County, North Dakota",NA,2023,795,0,795,0
38089,"Stark County, North Dakota",NA,2023,33116,568,32548,1.715182993
38091,"Steele County, North Dakota",NA,2023,1731,3,1728,0.173310225
38093,"Stutsman County, North Dakota",NA,2023,21525,346,21179,1.607433217
38095,"Towner County, North Dakota",NA,2023,2113,32,2081,1.514434453
38097,"Traill County, North Dakota",NA,2023,7980,131,7849,1.64160401
38099,"Walsh County, North Dakota",NA,2023,10488,199,10289,1.89740656
38101,"Ward County, North Dakota",NA,2023,69232,1558,67674,2.250404437
38103,"Wells County, North Dakota",NA,2023,3942,11,3931,0.279046169
38105,"Williams County, North Dakota",NA,2023,39368,1638,37730,4.160739687
39001,"Adams County, Ohio",NA,2023,27510,206,27304,0.748818611
39003,"Allen County, Ohio",NA,2023,101685,808,100877,0.794610808
39005,"Ashland County, Ohio",NA,2023,52296,310,51986,0.592779562
39007,"Ashtabula County, Ohio",NA,2023,97343,632,96711,0.649250588
39009,"Athens County, Ohio",NA,2023,61573,1631,59942,2.648888311
39011,"Auglaize County, Ohio",NA,2023,46209,107,46102,0.231556623
39013,"Belmont County, Ohio",NA,2023,65982,220,65762,0.333424267
39015,"Brown County, Ohio",NA,2023,43710,100,43610,0.228780599
39017,"Butler County, Ohio",NA,2023,389910,16905,373005,4.335615911
39019,"Carroll County, Ohio",NA,2023,26731,52,26679,0.194530695
39021,"Champaign County, Ohio",NA,2023,38772,106,38666,0.27339317
39023,"Clark County, Ohio",NA,2023,135445,1800,133645,1.328952711
39025,"Clermont County, Ohio",NA,2023,209862,2015,207847,0.960154768
39027,"Clinton County, Ohio",NA,2023,42014,768,41246,1.827962108
39029,"Columbiana County, Ohio",NA,2023,101203,431,100772,0.425876703
39031,"Coshocton County, Ohio",NA,2023,36679,77,36602,0.209929387
39033,"Crawford County, Ohio",NA,2023,41767,351,41416,0.840376374
39035,"Cuyahoga County, Ohio",NA,2023,1249418,35949,1213469,2.877259652
39037,"Darke County, Ohio",NA,2023,51655,279,51376,0.540121963
39039,"Defiance County, Ohio",NA,2023,38258,338,37920,0.883475352
39041,"Delaware County, Ohio",NA,2023,221160,9357,211803,4.230873576
39043,"Erie County, Ohio",NA,2023,74938,471,74467,0.628519576
39045,"Fairfield County, Ohio",NA,2023,161289,2500,158789,1.55001271
39047,"Fayette County, Ohio",NA,2023,28880,237,28643,0.820637119
39049,"Franklin County, Ohio",NA,2023,1321635,85132,1236503,6.441415368
39051,"Fulton County, Ohio",NA,2023,42434,330,42104,0.777678277
39053,"Gallia County, Ohio",NA,2023,29162,60,29102,0.205747205
39055,"Geauga County, Ohio",NA,2023,95479,581,94898,0.608510772
39057,"Greene County, Ohio",NA,2023,168531,2980,165551,1.768220683
39059,"Guernsey County, Ohio",NA,2023,38283,50,38233,0.130606274
39061,"Hamilton County, Ohio",NA,2023,827878,29660,798218,3.582653483
39063,"Hancock County, Ohio",NA,2023,74885,1592,73293,2.125926421
39065,"Hardin County, Ohio",NA,2023,30527,224,30303,0.733776657
39067,"Harrison County, Ohio",NA,2023,14408,34,14374,0.235980011
39069,"Henry County, Ohio",NA,2023,27581,229,27352,0.830281716
39071,"Highland County, Ohio",NA,2023,43403,171,43232,0.393981983
39073,"Hocking County, Ohio",NA,2023,27938,30,27908,0.107380629
39075,"Holmes County, Ohio",NA,2023,44312,72,44240,0.162484203
39077,"Huron County, Ohio",NA,2023,58412,683,57729,1.169280285
39079,"Jackson County, Ohio",NA,2023,32588,143,32445,0.438811833
39081,"Jefferson County, Ohio",NA,2023,64855,351,64504,0.541207309
39083,"Knox County, Ohio",NA,2023,62888,614,62274,0.976338888
39085,"Lake County, Ohio",NA,2023,232101,4344,227757,1.871599002
39087,"Lawrence County, Ohio",NA,2023,57385,126,57259,0.219569574
39089,"Licking County, Ohio",NA,2023,180311,1942,178369,1.077028024
39091,"Logan County, Ohio",NA,2023,46140,426,45714,0.923276983
39093,"Lorain County, Ohio",NA,2023,314588,3750,310838,1.192035297
39095,"Lucas County, Ohio",NA,2023,428748,6052,422696,1.411551774
39097,"Madison County, Ohio",NA,2023,44126,520,43606,1.178443548
39099,"Mahoning County, Ohio",NA,2023,227063,2347,224716,1.033633837
39101,"Marion County, Ohio",NA,2023,65145,392,64753,0.601734592
39103,"Medina County, Ohio",NA,2023,183049,1971,181078,1.076760867
39105,"Meigs County, Ohio",NA,2023,22072,113,21959,0.511960855
39107,"Mercer County, Ohio",NA,2023,42438,391,42047,0.921344078
39109,"Miami County, Ohio",NA,2023,109549,1252,108297,1.142867575
39111,"Monroe County, Ohio",NA,2023,13308,40,13268,0.300571085
39113,"Montgomery County, Ohio",NA,2023,535528,12981,522547,2.423962893
39115,"Morgan County, Ohio",NA,2023,13758,31,13727,0.225323448
39117,"Morrow County, Ohio",NA,2023,35214,78,35136,0.221502811
39119,"Muskingum County, Ohio",NA,2023,86382,401,85981,0.464217082
39121,"Noble County, Ohio",NA,2023,14252,47,14205,0.329778277
39123,"Ottawa County, Ohio",NA,2023,40161,108,40053,0.268917607
39125,"Paulding County, Ohio",NA,2023,18800,176,18624,0.936170213
39127,"Perry County, Ohio",NA,2023,35474,151,35323,0.425663866
39129,"Pickaway County, Ohio",NA,2023,59407,100,59307,0.168330331
39131,"Pike County, Ohio",NA,2023,27080,100,26980,0.369276219
39133,"Portage County, Ohio",NA,2023,161421,2942,158479,1.822563359
39135,"Preble County, Ohio",NA,2023,40802,83,40719,0.203421401
39137,"Putnam County, Ohio",NA,2023,34352,300,34052,0.873311598
39139,"Richland County, Ohio",NA,2023,125138,734,124404,0.586552446
39141,"Ross County, Ohio",NA,2023,76748,328,76420,0.4273727
39143,"Sandusky County, Ohio",NA,2023,58770,553,58217,0.94095627
39145,"Scioto County, Ohio",NA,2023,73118,306,72812,0.4185016
39147,"Seneca County, Ohio",NA,2023,54861,404,54457,0.736406555
39149,"Shelby County, Ohio",NA,2023,48007,266,47741,0.554085862
39151,"Stark County, Ohio",NA,2023,373764,3433,370331,0.918494023
39153,"Summit County, Ohio",NA,2023,538087,13358,524729,2.482498183
39155,"Trumbull County, Ohio",NA,2023,201367,700,200667,0.34762399
39157,"Tuscarawas County, Ohio",NA,2023,92585,1349,91236,1.457039477
39159,"Union County, Ohio",NA,2023,65293,1719,63574,2.632747768
39161,"Van Wert County, Ohio",NA,2023,28824,156,28668,0.541215654
39163,"Vinton County, Ohio",NA,2023,12686,0,12686,0
39165,"Warren County, Ohio",NA,2023,246364,10457,235907,4.24453248
39167,"Washington County, Ohio",NA,2023,59318,355,58963,0.598469267
39169,"Wayne County, Ohio",NA,2023,116618,1809,114809,1.551218508
39171,"Williams County, Ohio",NA,2023,36862,296,36566,0.802994954
39173,"Wood County, Ohio",NA,2023,131795,1951,129844,1.480329299
39175,"Wyandot County, Ohio",NA,2023,21699,122,21577,0.562237891
40001,"Adair County, Oklahoma",NA,2023,19595,232,19363,1.183975504
40003,"Alfalfa County, Oklahoma",NA,2023,5685,25,5660,0.439753738
40005,"Atoka County, Oklahoma",NA,2023,14255,173,14082,1.21360926
40007,"Beaver County, Oklahoma",NA,2023,5041,452,4589,8.966474906
40009,"Beckham County, Oklahoma",NA,2023,22202,490,21712,2.207008378
40011,"Blaine County, Oklahoma",NA,2023,8603,449,8154,5.219109613
40013,"Bryan County, Oklahoma",NA,2023,47237,840,46397,1.778267036
40015,"Caddo County, Oklahoma",NA,2023,26626,982,25644,3.68812439
40017,"Canadian County, Oklahoma",NA,2023,162621,3468,159153,2.132565905
40019,"Carter County, Oklahoma",NA,2023,48255,767,47488,1.589472594
40021,"Cherokee County, Oklahoma",NA,2023,47621,875,46746,1.837424666
40023,"Choctaw County, Oklahoma",NA,2023,14299,150,14149,1.049024407
40025,"Cimarron County, Oklahoma",NA,2023,2247,86,2161,3.827325323
40027,"Cleveland County, Oklahoma",NA,2023,297545,9733,287812,3.27110185
40029,"Coal County, Oklahoma",NA,2023,5275,23,5252,0.436018957
40031,"Comanche County, Oklahoma",NA,2023,121699,2952,118747,2.425656743
40033,"Cotton County, Oklahoma",NA,2023,5475,21,5454,0.383561644
40035,"Craig County, Oklahoma",NA,2023,14215,182,14033,1.280337671
40037,"Creek County, Oklahoma",NA,2023,72353,689,71664,0.952275649
40039,"Custer County, Oklahoma",NA,2023,28332,869,27463,3.067203163
40041,"Delaware County, Oklahoma",NA,2023,41017,297,40720,0.724090011
40043,"Dewey County, Oklahoma",NA,2023,4433,49,4384,1.105346267
40045,"Ellis County, Oklahoma",NA,2023,3717,106,3611,2.851762174
40047,"Garfield County, Oklahoma",NA,2023,62322,2657,59665,4.263341998
40049,"Garvin County, Oklahoma",NA,2023,25779,649,25130,2.517553047
40051,"Grady County, Oklahoma",NA,2023,55868,648,55220,1.159876853
40053,"Grant County, Oklahoma",NA,2023,4137,5,4132,0.120860527
40055,"Greer County, Oklahoma",NA,2023,5498,47,5451,0.854856311
40057,"Harmon County, Oklahoma",NA,2023,2452,60,2392,2.446982055
40059,"Harper County, Oklahoma",NA,2023,3231,377,2854,11.66821418
40061,"Haskell County, Oklahoma",NA,2023,11667,161,11506,1.379960573
40063,"Hughes County, Oklahoma",NA,2023,13411,203,13208,1.513682798
40065,"Jackson County, Oklahoma",NA,2023,24730,810,23920,3.27537404
40067,"Jefferson County, Oklahoma",NA,2023,5377,82,5295,1.525013948
40069,"Johnston County, Oklahoma",NA,2023,10334,130,10204,1.257983356
40071,"Kay County, Oklahoma",NA,2023,43731,674,43057,1.541240767
40073,"Kingfisher County, Oklahoma",NA,2023,15288,977,14311,6.390633176
40075,"Kiowa County, Oklahoma",NA,2023,8458,35,8423,0.413809411
40077,"Latimer County, Oklahoma",NA,2023,9495,36,9459,0.379146919
40079,"Le Flore County, Oklahoma",NA,2023,48728,1247,47481,2.559103595
40081,"Lincoln County, Oklahoma",NA,2023,33917,203,33714,0.598519916
40083,"Logan County, Oklahoma",NA,2023,50905,1196,49709,2.349474511
40085,"Love County, Oklahoma",NA,2023,10196,292,9904,2.863868184
40087,"McClain County, Oklahoma",NA,2023,43779,758,43021,1.731423742
40089,"McCurtain County, Oklahoma",NA,2023,30825,617,30208,2.00162206
40091,"McIntosh County, Oklahoma",NA,2023,19237,81,19156,0.421063575
40093,"Major County, Oklahoma",NA,2023,7656,201,7455,2.62539185
40095,"Marshall County, Oklahoma",NA,2023,15628,612,15016,3.916048119
40097,"Mayes County, Oklahoma",NA,2023,39406,217,39189,0.550677562
40099,"Murray County, Oklahoma",NA,2023,13807,131,13676,0.94879409
40101,"Muskogee County, Oklahoma",NA,2023,66471,919,65552,1.382557807
40103,"Noble County, Oklahoma",NA,2023,10909,36,10873,0.33000275
40105,"Nowata County, Oklahoma",NA,2023,9392,49,9343,0.521720613
40107,"Okfuskee County, Oklahoma",NA,2023,11304,125,11179,1.105803255
40109,"Oklahoma County, Oklahoma",NA,2023,800487,52823,747664,6.598857945
40111,"Okmulgee County, Oklahoma",NA,2023,36922,286,36636,0.774605926
40113,"Osage County, Oklahoma",NA,2023,45963,284,45679,0.617888301
40115,"Ottawa County, Oklahoma",NA,2023,30360,523,29837,1.722661397
40117,"Pawnee County, Oklahoma",NA,2023,15689,78,15611,0.497163618
40119,"Payne County, Oklahoma",NA,2023,82290,3767,78523,4.577712966
40121,"Pittsburg County, Oklahoma",NA,2023,43629,340,43289,0.779298173
40123,"Pontotoc County, Oklahoma",NA,2023,38158,360,37798,0.943445673
40125,"Pottawatomie County, Oklahoma",NA,2023,73011,757,72254,1.036830067
40127,"Pushmataha County, Oklahoma",NA,2023,10787,73,10714,0.676740521
40129,"Roger Mills County, Oklahoma",NA,2023,3378,50,3328,1.480165779
40131,"Rogers County, Oklahoma",NA,2023,97235,1303,95932,1.34005245
40133,"Seminole County, Oklahoma",NA,2023,23550,245,23305,1.040339703
40135,"Sequoyah County, Oklahoma",NA,2023,39676,382,39294,0.962798669
40137,"Stephens County, Oklahoma",NA,2023,43314,629,42685,1.45218636
40139,"Texas County, Oklahoma",NA,2023,20880,4253,16627,20.36877395
40141,"Tillman County, Oklahoma",NA,2023,6967,169,6798,2.425721257
40143,"Tulsa County, Oklahoma",NA,2023,673708,41039,632669,6.091511456
40145,"Wagoner County, Oklahoma",NA,2023,84339,2043,82296,2.422366877
40147,"Washington County, Oklahoma",NA,2023,52895,1071,51824,2.024766046
40149,"Washita County, Oklahoma",NA,2023,10857,114,10743,1.050013816
40151,"Woods County, Oklahoma",NA,2023,8619,119,8500,1.380670611
40153,"Woodward County, Oklahoma",NA,2023,20260,645,19615,3.183613031
41001,"Baker County, Oregon",NA,2023,16796,66,16730,0.392950703
41003,"Benton County, Oregon",NA,2023,96359,6079,90280,6.308699758
41005,"Clackamas County, Oregon",NA,2023,422308,14342,407966,3.396099529
41007,"Clatsop County, Oregon",NA,2023,41343,793,40550,1.918099799
41009,"Columbia County, Oregon",NA,2023,53178,607,52571,1.141449472
41011,"Coos County, Oregon",NA,2023,64832,1131,63701,1.744508885
41013,"Crook County, Oregon",NA,2023,25651,118,25533,0.460021052
41015,"Curry County, Oregon",NA,2023,23463,487,22976,2.075608405
41017,"Deschutes County, Oregon",NA,2023,203026,5521,197505,2.719356142
41019,"Douglas County, Oregon",NA,2023,111807,1011,110796,0.904236765
41021,"Gilliam County, Oregon",NA,2023,2002,28,1974,1.398601399
41023,"Grant County, Oregon",NA,2023,7238,69,7169,0.953302017
41025,"Harney County, Oregon",NA,2023,7515,140,7375,1.862940785
41027,"Hood River County, Oregon",NA,2023,23958,2645,21313,11.0401536
41029,"Jackson County, Oregon",NA,2023,222563,6207,216356,2.788873263
41031,"Jefferson County, Oregon",NA,2023,24973,1026,23947,4.108437112
41033,"Josephine County, Oregon",NA,2023,88069,1374,86695,1.560140345
41035,"Klamath County, Oregon",NA,2023,69812,1677,68135,2.402165817
41037,"Lake County, Oregon",NA,2023,8254,445,7809,5.391325418
41039,"Lane County, Oregon",NA,2023,382628,10652,371976,2.783904994
41041,"Lincoln County, Oregon",NA,2023,50632,1567,49065,3.094880708
41043,"Linn County, Oregon",NA,2023,129794,3123,126671,2.406120468
41045,"Malheur County, Oregon",NA,2023,31701,1576,30125,4.971452005
41047,"Marion County, Oregon",NA,2023,346532,29683,316849,8.565731303
41049,"Morrow County, Oregon",NA,2023,12249,1686,10563,13.76438893
41051,"Multnomah County, Oregon",NA,2023,803863,46467,757396,5.780462591
41053,"Polk County, Oregon",NA,2023,88553,2405,86148,2.71588766
41055,"Sherman County, Oregon",NA,2023,1908,16,1892,0.838574423
41057,"Tillamook County, Oregon",NA,2023,27471,986,26485,3.589239562
41059,"Umatilla County, Oregon",NA,2023,80087,5513,74574,6.883763907
41061,"Union County, Oregon",NA,2023,26192,476,25716,1.817348809
41063,"Wallowa County, Oregon",NA,2023,7532,49,7483,0.650557621
41065,"Wasco County, Oregon",NA,2023,26603,1661,24942,6.24365673
41067,"Washington County, Oregon",NA,2023,600266,53495,546771,8.911882399
41069,"Wheeler County, Oregon",NA,2023,1434,42,1392,2.928870293
41071,"Yamhill County, Oregon",NA,2023,108122,5081,103041,4.699321137
42001,"Adams County, Pennsylvania",NA,2023,105183,1792,103391,1.703697366
42003,"Allegheny County, Pennsylvania",NA,2023,1240476,39772,1200704,3.206188592
42005,"Armstrong County, Pennsylvania",NA,2023,65069,235,64834,0.361155082
42007,"Beaver County, Pennsylvania",NA,2023,166993,1027,165966,0.614995838
42009,"Bedford County, Pennsylvania",NA,2023,47503,199,47304,0.41892091
42011,"Berks County, Pennsylvania",NA,2023,429989,17232,412757,4.007544379
42013,"Blair County, Pennsylvania",NA,2023,121854,864,120990,0.709045251
42015,"Bradford County, Pennsylvania",NA,2023,59971,560,59411,0.933784663
42017,"Bucks County, Pennsylvania",NA,2023,645993,22384,623609,3.465053027
42019,"Butler County, Pennsylvania",NA,2023,195870,1612,194258,0.822994844
42021,"Cambria County, Pennsylvania",NA,2023,132355,526,131829,0.39741604
42023,"Cameron County, Pennsylvania",NA,2023,4475,8,4467,0.17877095
42025,"Carbon County, Pennsylvania",NA,2023,65191,625,64566,0.958721296
42027,"Centre County, Pennsylvania",NA,2023,158041,8786,149255,5.559316886
42029,"Chester County, Pennsylvania",NA,2023,540896,26296,514600,4.861563036
42031,"Clarion County, Pennsylvania",NA,2023,37297,198,37099,0.530873797
42033,"Clearfield County, Pennsylvania",NA,2023,78902,986,77916,1.249651466
42035,"Clinton County, Pennsylvania",NA,2023,37707,182,37525,0.482669
42037,"Columbia County, Pennsylvania",NA,2023,65055,492,64563,0.756283145
42039,"Crawford County, Pennsylvania",NA,2023,83189,382,82807,0.459195326
42041,"Cumberland County, Pennsylvania",NA,2023,264422,8233,256189,3.11358359
42043,"Dauphin County, Pennsylvania",NA,2023,287484,11893,275591,4.136925881
42045,"Delaware County, Pennsylvania",NA,2023,576195,24965,551230,4.332734578
42047,"Elk County, Pennsylvania",NA,2023,30703,143,30560,0.465752532
42049,"Erie County, Pennsylvania",NA,2023,269544,4991,264553,1.851645742
42051,"Fayette County, Pennsylvania",NA,2023,126967,998,125969,0.786031016
42053,"Forest County, Pennsylvania",NA,2023,6785,90,6695,1.326455416
42055,"Franklin County, Pennsylvania",NA,2023,156626,3137,153489,2.002860317
42057,"Fulton County, Pennsylvania",NA,2023,14545,55,14490,0.378136817
42059,"Greene County, Pennsylvania",NA,2023,35265,150,35115,0.425350915
42061,"Huntingdon County, Pennsylvania",NA,2023,43844,228,43616,0.520025545
42063,"Indiana County, Pennsylvania",NA,2023,83213,1199,82014,1.440880632
42065,"Jefferson County, Pennsylvania",NA,2023,44099,131,43968,0.29705889
42067,"Juniata County, Pennsylvania",NA,2023,23419,387,23032,1.652504377
42069,"Lackawanna County, Pennsylvania",NA,2023,215834,6039,209795,2.797983636
42071,"Lancaster County, Pennsylvania",NA,2023,555151,11931,543220,2.149145007
42073,"Lawrence County, Pennsylvania",NA,2023,85423,521,84902,0.609905997
42075,"Lebanon County, Pennsylvania",NA,2023,143592,2219,141373,1.545350716
42077,"Lehigh County, Pennsylvania",NA,2023,375408,23173,352235,6.172750714
42079,"Luzerne County, Pennsylvania",NA,2023,325978,14835,311143,4.550920614
42081,"Lycoming County, Pennsylvania",NA,2023,113570,1077,112493,0.948313815
42083,"McKean County, Pennsylvania",NA,2023,40149,415,39734,1.033649655
42085,"Mercer County, Pennsylvania",NA,2023,109852,431,109421,0.392346066
42087,"Mifflin County, Pennsylvania",NA,2023,46074,87,45987,0.18882667
42089,"Monroe County, Pennsylvania",NA,2023,167784,5140,162644,3.063462547
42091,"Montgomery County, Pennsylvania",NA,2023,861225,38383,822842,4.456791199
42093,"Montour County, Pennsylvania",NA,2023,18079,561,17518,3.103047735
42095,"Northampton County, Pennsylvania",NA,2023,315927,9739,306188,3.082674162
42097,"Northumberland County, Pennsylvania",NA,2023,90925,821,90104,0.902941985
42099,"Perry County, Pennsylvania",NA,2023,45988,348,45640,0.756719144
42101,"Philadelphia County, Pennsylvania",NA,2023,1582432,112130,1470302,7.085928495
42103,"Pike County, Pennsylvania",NA,2023,59691,1314,58377,2.201336885
42105,"Potter County, Pennsylvania",NA,2023,16276,80,16196,0.491521258
42107,"Schuylkill County, Pennsylvania",NA,2023,143259,1573,141686,1.098011294
42109,"Snyder County, Pennsylvania",NA,2023,39711,210,39501,0.52882073
42111,"Somerset County, Pennsylvania",NA,2023,73255,283,72972,0.386321753
42113,"Sullivan County, Pennsylvania",NA,2023,5849,30,5819,0.512908189
42115,"Susquehanna County, Pennsylvania",NA,2023,38349,305,38044,0.795327127
42117,"Tioga County, Pennsylvania",NA,2023,41078,133,40945,0.323774283
42119,"Union County, Pennsylvania",NA,2023,42570,1123,41447,2.638007987
42121,"Venango County, Pennsylvania",NA,2023,50096,176,49920,0.351325455
42123,"Warren County, Pennsylvania",NA,2023,38174,152,38022,0.39817677
42125,"Washington County, Pennsylvania",NA,2023,209778,2079,207699,0.991047679
42127,"Wayne County, Pennsylvania",NA,2023,51189,456,50733,0.890816386
42129,"Westmoreland County, Pennsylvania",NA,2023,353345,2252,351093,0.637337446
42131,"Wyoming County, Pennsylvania",NA,2023,26075,194,25881,0.74400767
42133,"York County, Pennsylvania",NA,2023,459312,8982,450330,1.955533494
44001,"Bristol County, Rhode Island",NA,2023,50568,1040,49528,2.056636608
44003,"Kent County, Rhode Island",NA,2023,170658,4786,165872,2.804439288
44005,"Newport County, Rhode Island",NA,2023,85095,2507,82588,2.946119043
44007,"Providence County, Rhode Island",NA,2023,658977,63265,595712,9.600486815
44009,"Washington County, Rhode Island",NA,2023,130073,2371,127702,1.822822569
45001,"Abbeville County, South Carolina",NA,2023,24352,151,24201,0.620072273
45003,"Aiken County, South Carolina",NA,2023,171949,3138,168811,1.824959726
45005,"Allendale County, South Carolina",NA,2023,7738,90,7648,1.163091238
45007,"Anderson County, South Carolina",NA,2023,207218,4091,203127,1.974249341
45009,"Bamberg County, South Carolina",NA,2023,13164,222,12942,1.686417502
45011,"Barnwell County, South Carolina",NA,2023,20565,296,20269,1.439338682
45013,"Beaufort County, South Carolina",NA,2023,192123,8614,183509,4.483586036
45015,"Berkeley County, South Carolina",NA,2023,238723,7522,231201,3.150932252
45017,"Calhoun County, South Carolina",NA,2023,14150,78,14072,0.551236749
45019,"Charleston County, South Carolina",NA,2023,414711,15211,399500,3.667855446
45021,"Cherokee County, South Carolina",NA,2023,56299,1197,55102,2.126147889
45023,"Chester County, South Carolina",NA,2023,32177,128,32049,0.397799671
45025,"Chesterfield County, South Carolina",NA,2023,43575,687,42888,1.576592083
45027,"Clarendon County, South Carolina",NA,2023,31037,297,30740,0.956922383
45029,"Colleton County, South Carolina",NA,2023,38623,790,37833,2.045413355
45031,"Darlington County, South Carolina",NA,2023,62754,398,62356,0.63422252
45033,"Dillon County, South Carolina",NA,2023,28031,247,27784,0.881167279
45035,"Dorchester County, South Carolina",NA,2023,164322,5410,158912,3.292316306
45037,"Edgefield County, South Carolina",NA,2023,26508,1033,25475,3.896936774
45039,"Fairfield County, South Carolina",NA,2023,20741,33,20708,0.159105154
45041,"Florence County, South Carolina",NA,2023,136921,1986,134935,1.45047144
45043,"Georgetown County, South Carolina",NA,2023,64200,787,63413,1.225856698
45045,"Greenville County, South Carolina",NA,2023,537575,26390,511185,4.909082454
45047,"Greenwood County, South Carolina",NA,2023,69329,1647,67682,2.375629246
45049,"Hampton County, South Carolina",NA,2023,18555,492,18063,2.651576395
45051,"Horry County, South Carolina",NA,2023,368937,12881,356056,3.491381997
45053,"Jasper County, South Carolina",NA,2023,30658,2347,28311,7.655424359
45055,"Kershaw County, South Carolina",NA,2023,66924,1082,65842,1.616759309
45057,"Lancaster County, South Carolina",NA,2023,100905,4060,96845,4.023586542
45059,"Laurens County, South Carolina",NA,2023,67904,2029,65875,2.988041942
45061,"Lee County, South Carolina",NA,2023,16330,380,15950,2.327005511
45063,"Lexington County, South Carolina",NA,2023,300370,10396,289974,3.461064687
45065,"McCormick County, South Carolina",NA,2023,9701,8,9693,0.082465725
45067,"Marion County, South Carolina",NA,2023,28900,403,28497,1.394463668
45069,"Marlboro County, South Carolina",NA,2023,26285,283,26002,1.076659692
45071,"Newberry County, South Carolina",NA,2023,38121,1513,36608,3.968941004
45073,"Oconee County, South Carolina",NA,2023,79566,2024,77542,2.543800116
45075,"Orangeburg County, South Carolina",NA,2023,83531,738,82793,0.883504328
45077,"Pickens County, South Carolina",NA,2023,132604,3130,129474,2.360411451
45079,"Richland County, South Carolina",NA,2023,418725,13091,405634,3.126395606
45081,"Saluda County, South Carolina",NA,2023,18958,1075,17883,5.67042937
45083,"Spartanburg County, South Carolina",NA,2023,338096,14033,324063,4.15059628
45085,"Sumter County, South Carolina",NA,2023,104853,1183,103670,1.128246211
45087,"Union County, South Carolina",NA,2023,26990,166,26824,0.615042608
45089,"Williamsburg County, South Carolina",NA,2023,30517,705,29812,2.310187764
45091,"York County, South Carolina",NA,2023,288559,10569,277990,3.662682502
46003,"Aurora County, South Dakota",NA,2023,2573,100,2473,3.886513797
46005,"Beadle County, South Dakota",NA,2023,19279,1623,17656,8.418486436
46007,"Bennett County, South Dakota",NA,2023,3354,40,3314,1.192605844
46009,"Bon Homme County, South Dakota",NA,2023,7024,31,6993,0.441343964
46011,"Brookings County, South Dakota",NA,2023,34968,1335,33633,3.817776253
46013,"Brown County, South Dakota",NA,2023,38079,811,37268,2.12978282
46015,"Brule County, South Dakota",NA,2023,5261,19,5242,0.361148071
46017,"Buffalo County, South Dakota",NA,2023,1757,0,1757,0
46019,"Butte County, South Dakota",NA,2023,10538,26,10512,0.246726134
46021,"Campbell County, South Dakota",NA,2023,1481,38,1443,2.565833896
46023,"Charles Mix County, South Dakota",NA,2023,9281,42,9239,0.452537442
46025,"Clark County, South Dakota",NA,2023,3876,70,3806,1.805985552
46027,"Clay County, South Dakota",NA,2023,15133,584,14549,3.85911584
46029,"Codington County, South Dakota",NA,2023,28556,239,28317,0.836951954
46031,"Corson County, South Dakota",NA,2023,3859,4,3855,0.103653796
46033,"Custer County, South Dakota",NA,2023,8686,49,8637,0.56412618
46035,"Davison County, South Dakota",NA,2023,19936,251,19685,1.259028892
46037,"Day County, South Dakota",NA,2023,5460,14,5446,0.256410256
46039,"Deuel County, South Dakota",NA,2023,4318,27,4291,0.625289486
46041,"Dewey County, South Dakota",NA,2023,5230,19,5211,0.363288719
46043,"Douglas County, South Dakota",NA,2023,2823,45,2778,1.594048884
46045,"Edmunds County, South Dakota",NA,2023,4033,34,3999,0.84304488
46047,"Fall River County, South Dakota",NA,2023,7179,70,7109,0.975066165
46049,"Faulk County, South Dakota",NA,2023,2137,2,2135,0.093589144
46051,"Grant County, South Dakota",NA,2023,7544,345,7199,4.573170732
46053,"Gregory County, South Dakota",NA,2023,3993,6,3987,0.15026296
46055,"Haakon County, South Dakota",NA,2023,1708,0,1708,0
46057,"Hamlin County, South Dakota",NA,2023,6288,225,6063,3.578244275
46059,"Hand County, South Dakota",NA,2023,3045,32,3013,1.05090312
46061,"Hanson County, South Dakota",NA,2023,3473,30,3443,0.863806507
46063,"Harding County, South Dakota",NA,2023,1092,9,1083,0.824175824
46065,"Hughes County, South Dakota",NA,2023,17732,34,17698,0.19174374
46067,"Hutchinson County, South Dakota",NA,2023,7393,36,7357,0.486947112
46069,"Hyde County, South Dakota",NA,2023,1305,0,1305,0
46071,"Jackson County, South Dakota",NA,2023,2826,5,2821,0.176928521
46073,"Jerauld County, South Dakota",NA,2023,1845,42,1803,2.276422764
46075,"Jones County, South Dakota",NA,2023,1030,35,995,3.398058252
46077,"Kingsbury County, South Dakota",NA,2023,5210,16,5194,0.307101727
46079,"Lake County, South Dakota",NA,2023,11052,204,10848,1.845819761
46081,"Lawrence County, South Dakota",NA,2023,26574,316,26258,1.189132235
46083,"Lincoln County, South Dakota",NA,2023,68286,1466,66820,2.146852942
46085,"Lyman County, South Dakota",NA,2023,3717,28,3689,0.753295669
46087,"McCook County, South Dakota",NA,2023,5732,21,5711,0.366364271
46089,"McPherson County, South Dakota",NA,2023,2278,16,2262,0.7023705
46091,"Marshall County, South Dakota",NA,2023,4355,66,4289,1.515499426
46093,"Meade County, South Dakota",NA,2023,30297,276,30021,0.910981285
46095,"Mellette County, South Dakota",NA,2023,2043,0,2043,0
46097,"Miner County, South Dakota",NA,2023,2299,0,2299,0
46099,"Minnehaha County, South Dakota",NA,2023,200689,8242,192447,4.106851895
46101,"Moody County, South Dakota",NA,2023,6371,151,6220,2.370114582
46102,"Oglala Lakota County, South Dakota",NA,2023,13587,0,13587,0
46103,"Pennington County, South Dakota",NA,2023,112081,928,111153,0.827972627
46105,"Perkins County, South Dakota",NA,2023,3058,9,3049,0.294310007
46107,"Potter County, South Dakota",NA,2023,2430,0,2430,0
46109,"Roberts County, South Dakota",NA,2023,10219,63,10156,0.616498679
46111,"Sanborn County, South Dakota",NA,2023,2370,41,2329,1.729957806
46115,"Spink County, South Dakota",NA,2023,6283,63,6220,1.002705714
46117,"Stanley County, South Dakota",NA,2023,3012,0,3012,0
46119,"Sully County, South Dakota",NA,2023,1481,61,1420,4.118838623
46121,"Todd County, South Dakota",NA,2023,9293,260,9033,2.797804799
46123,"Tripp County, South Dakota",NA,2023,5607,65,5542,1.159265204
46125,"Turner County, South Dakota",NA,2023,8772,159,8613,1.812585499
46127,"Union County, South Dakota",NA,2023,16916,236,16680,1.395128872
46129,"Walworth County, South Dakota",NA,2023,5298,10,5288,0.188750472
46135,"Yankton County, South Dakota",NA,2023,23379,542,22837,2.31831986
46137,"Ziebach County, South Dakota",NA,2023,2410,10,2400,0.414937759
47001,"Anderson County, Tennessee",NA,2023,78175,1419,76756,1.815158299
47003,"Bedford County, Tennessee",NA,2023,51291,2968,48323,5.78659024
47005,"Benton County, Tennessee",NA,2023,15948,35,15913,0.219463256
47007,"Bledsoe County, Tennessee",NA,2023,14905,145,14760,0.97282791
47009,"Blount County, Tennessee",NA,2023,137747,2416,135331,1.753940195
47011,"Bradley County, Tennessee",NA,2023,109743,3405,106338,3.102703589
47013,"Campbell County, Tennessee",NA,2023,39568,184,39384,0.46502224
47015,"Cannon County, Tennessee",NA,2023,14661,116,14545,0.791214788
47017,"Carroll County, Tennessee",NA,2023,28461,191,28270,0.671093777
47019,"Carter County, Tennessee",NA,2023,56462,862,55600,1.526690518
47021,"Cheatham County, Tennessee",NA,2023,41500,945,40555,2.277108434
47023,"Chester County, Tennessee",NA,2023,17452,101,17351,0.578730231
47025,"Claiborne County, Tennessee",NA,2023,32221,198,32023,0.614506067
47027,"Clay County, Tennessee",NA,2023,7621,122,7499,1.600839785
47029,"Cocke County, Tennessee",NA,2023,36503,147,36356,0.402706627
47031,"Coffee County, Tennessee",NA,2023,58940,960,57980,1.628775025
47033,"Crockett County, Tennessee",NA,2023,13937,530,13407,3.802827007
47035,"Cumberland County, Tennessee",NA,2023,62529,806,61723,1.289001903
47037,"Davidson County, Tennessee",NA,2023,709846,66618,643228,9.384852489
47039,"Decatur County, Tennessee",NA,2023,11499,99,11400,0.86094443
47041,"DeKalb County, Tennessee",NA,2023,20551,775,19776,3.771106029
47043,"Dickson County, Tennessee",NA,2023,55197,624,54573,1.130496223
47045,"Dyer County, Tennessee",NA,2023,36681,356,36325,0.970529702
47047,"Fayette County, Tennessee",NA,2023,42653,608,42045,1.425456592
47049,"Fentress County, Tennessee",NA,2023,18948,68,18880,0.358876926
47051,"Franklin County, Tennessee",NA,2023,43478,766,42712,1.761810571
47053,"Gibson County, Tennessee",NA,2023,50610,584,50026,1.15392215
47055,"Giles County, Tennessee",NA,2023,30442,204,30238,0.670126799
47057,"Grainger County, Tennessee",NA,2023,23929,273,23656,1.140875089
47059,"Greene County, Tennessee",NA,2023,70919,650,70269,0.916538586
47061,"Grundy County, Tennessee",NA,2023,13665,29,13636,0.212221003
47063,"Hamblen County, Tennessee",NA,2023,64930,3816,61114,5.877098414
47065,"Hamilton County, Tennessee",NA,2023,370913,13472,357441,3.632118583
47067,"Hancock County, Tennessee",NA,2023,6790,58,6732,0.854197349
47069,"Hardeman County, Tennessee",NA,2023,25477,148,25329,0.58091612
47071,"Hardin County, Tennessee",NA,2023,26939,192,26747,0.712721333
47073,"Hawkins County, Tennessee",NA,2023,57446,301,57145,0.523970337
47075,"Haywood County, Tennessee",NA,2023,17672,197,17475,1.114757809
47077,"Henderson County, Tennessee",NA,2023,27906,224,27682,0.802694761
47079,"Henry County, Tennessee",NA,2023,32345,151,32194,0.466841861
47081,"Hickman County, Tennessee",NA,2023,25229,130,25099,0.515280035
47083,"Houston County, Tennessee",NA,2023,8293,37,8256,0.446159412
47085,"Humphreys County, Tennessee",NA,2023,19074,192,18882,1.006605851
47087,"Jackson County, Tennessee",NA,2023,11882,8,11874,0.067328733
47089,"Jefferson County, Tennessee",NA,2023,55835,735,55100,1.316378616
47091,"Johnson County, Tennessee",NA,2023,18073,261,17812,1.444143197
47093,"Knox County, Tennessee",NA,2023,487401,17674,469727,3.626172289
47095,"Lake County, Tennessee",NA,2023,6691,81,6610,1.210581378
47097,"Lauderdale County, Tennessee",NA,2023,24933,173,24760,0.693859544
47099,"Lawrence County, Tennessee",NA,2023,44901,288,44613,0.641411104
47101,"Lewis County, Tennessee",NA,2023,12784,111,12673,0.868272841
47103,"Lincoln County, Tennessee",NA,2023,35617,562,35055,1.577898195
47105,"Loudon County, Tennessee",NA,2023,56996,2363,54633,4.145904976
47107,"McMinn County, Tennessee",NA,2023,54135,860,53275,1.58862104
47109,"McNairy County, Tennessee",NA,2023,25933,57,25876,0.21979717
47111,"Macon County, Tennessee",NA,2023,25793,570,25223,2.209901911
47113,"Madison County, Tennessee",NA,2023,98845,2117,96728,2.141737063
47115,"Marion County, Tennessee",NA,2023,29010,221,28789,0.761806274
47117,"Marshall County, Tennessee",NA,2023,35276,573,34703,1.624333825
47119,"Maury County, Tennessee",NA,2023,104855,1997,102858,1.904534834
47121,"Meigs County, Tennessee",NA,2023,13076,59,13017,0.451208321
47123,"Monroe County, Tennessee",NA,2023,47054,475,46579,1.009478472
47125,"Montgomery County, Tennessee",NA,2023,227957,7084,220873,3.107603627
47127,"Moore County, Tennessee",NA,2023,6611,6,6605,0.090757828
47129,"Morgan County, Tennessee",NA,2023,21193,62,21131,0.292549427
47131,"Obion County, Tennessee",NA,2023,30570,518,30052,1.694471704
47133,"Overton County, Tennessee",NA,2023,22807,43,22764,0.188538607
47135,"Perry County, Tennessee",NA,2023,8561,109,8452,1.273215746
47137,"Pickett County, Tennessee",NA,2023,5062,6,5056,0.118530225
47139,"Polk County, Tennessee",NA,2023,17702,32,17670,0.180770534
47141,"Putnam County, Tennessee",NA,2023,81366,2436,78930,2.993879507
47143,"Rhea County, Tennessee",NA,2023,33299,781,32518,2.345415778
47145,"Roane County, Tennessee",NA,2023,54403,292,54111,0.536735107
47147,"Robertson County, Tennessee",NA,2023,74291,2694,71597,3.626280438
47149,"Rutherford County, Tennessee",NA,2023,351591,21168,330423,6.020631927
47151,"Scott County, Tennessee",NA,2023,21969,49,21920,0.223041559
47153,"Sequatchie County, Tennessee",NA,2023,16409,329,16080,2.004997258
47155,"Sevier County, Tennessee",NA,2023,98802,5218,93584,5.28126961
47157,"Shelby County, Tennessee",NA,2023,922195,44124,878071,4.784671355
47159,"Smith County, Tennessee",NA,2023,20196,220,19976,1.089324619
47161,"Stewart County, Tennessee",NA,2023,13859,182,13677,1.313226062
47163,"Sullivan County, Tennessee",NA,2023,159693,1346,158347,0.842867252
47165,"Sumner County, Tennessee",NA,2023,200553,4959,195594,2.472663087
47167,"Tipton County, Tennessee",NA,2023,61339,335,61004,0.546145193
47169,"Trousdale County, Tennessee",NA,2023,11805,169,11636,1.431596781
47171,"Unicoi County, Tennessee",NA,2023,17779,16,17763,0.089993813
47173,"Union County, Tennessee",NA,2023,20141,19,20122,0.094334939
47175,"Van Buren County, Tennessee",NA,2023,6293,0,6293,0
47177,"Warren County, Tennessee",NA,2023,41587,1653,39934,3.974799817
47179,"Washington County, Tennessee",NA,2023,134693,2584,132109,1.918436741
47181,"Wayne County, Tennessee",NA,2023,16251,182,16069,1.119931081
47183,"Weakley County, Tennessee",NA,2023,32959,437,32522,1.325889742
47185,"White County, Tennessee",NA,2023,27764,171,27593,0.615905489
47187,"Williamson County, Tennessee",NA,2023,254609,11266,243343,4.424823946
47189,"Wilson County, Tennessee",NA,2023,153587,4882,148705,3.178654443
48001,"Anderson County, Texas",NA,2023,57825,2238,55587,3.870298314
48003,"Andrews County, Texas",NA,2023,18518,1630,16888,8.802246463
48005,"Angelina County, Texas",NA,2023,86791,4693,82098,5.407242686
48007,"Aransas County, Texas",NA,2023,24449,213,24236,0.871201276
48009,"Archer County, Texas",NA,2023,8734,296,8438,3.389054271
48011,"Armstrong County, Texas",NA,2023,1883,60,1823,3.186404673
48013,"Atascosa County, Texas",NA,2023,50058,2925,47133,5.843221863
48015,"Austin County, Texas",NA,2023,30712,1870,28842,6.088825215
48017,"Bailey County, Texas",NA,2023,7044,914,6130,12.97558206
48019,"Bandera County, Texas",NA,2023,21589,621,20968,2.876464866
48021,"Bastrop County, Texas",NA,2023,102370,9954,92416,9.723551822
48023,"Baylor County, Texas",NA,2023,3464,49,3415,1.414549654
48025,"Bee County, Texas",NA,2023,31000,753,30247,2.429032258
48027,"Bell County, Texas",NA,2023,379811,15066,364745,3.966709758
48029,"Bexar County, Texas",NA,2023,2037344,149465,1887879,7.336267218
48031,"Blanco County, Texas",NA,2023,12008,352,11656,2.931379081
48033,"Borden County, Texas",NA,2023,723,9,714,1.244813278
48035,"Bosque County, Texas",NA,2023,18546,723,17823,3.898414753
48037,"Bowie County, Texas",NA,2023,92321,2317,90004,2.509721515
48039,"Brazoria County, Texas",NA,2023,381650,24535,357115,6.428665007
48041,"Brazos County, Texas",NA,2023,237980,19556,218424,8.217497269
48043,"Brewster County, Texas",NA,2023,9464,359,9105,3.793322063
48045,"Briscoe County, Texas",NA,2023,1223,60,1163,4.905968929
48047,"Brooks County, Texas",NA,2023,6987,325,6662,4.651495635
48049,"Brown County, Texas",NA,2023,38294,845,37449,2.206612002
48051,"Burleson County, Texas",NA,2023,18327,908,17419,4.954438806
48053,"Burnet County, Texas",NA,2023,51064,2375,48689,4.651026163
48055,"Caldwell County, Texas",NA,2023,47184,4238,42946,8.981858257
48057,"Calhoun County, Texas",NA,2023,19921,1102,18819,5.531850811
48059,"Callahan County, Texas",NA,2023,14017,86,13931,0.613540701
48061,"Cameron County, Texas",NA,2023,423192,59074,364118,13.95914857
48063,"Camp County, Texas",NA,2023,12652,984,11668,7.777426494
48065,"Carson County, Texas",NA,2023,5802,15,5787,0.258531541
48067,"Cass County, Texas",NA,2023,28582,380,28202,1.329508082
48069,"Castro County, Texas",NA,2023,7328,888,6440,12.11790393
48071,"Chambers County, Texas",NA,2023,49178,2390,46788,4.859896702
48073,"Cherokee County, Texas",NA,2023,51143,3471,47672,6.786852551
48075,"Childress County, Texas",NA,2023,6772,192,6580,2.83520378
48077,"Clay County, Texas",NA,2023,10402,95,10307,0.913285907
48079,"Cochran County, Texas",NA,2023,2520,312,2208,12.38095238
48081,"Coke County, Texas",NA,2023,3315,4,3311,0.12066365
48083,"Coleman County, Texas",NA,2023,7765,343,7422,4.417256922
48085,"Collin County, Texas",NA,2023,1116601,125685,990916,11.25603506
48087,"Collingsworth County, Texas",NA,2023,2733,49,2684,1.792901573
48089,"Colorado County, Texas",NA,2023,20736,818,19918,3.944830247
48091,"Comal County, Texas",NA,2023,174552,4500,170052,2.578028324
48093,"Comanche County, Texas",NA,2023,13786,873,12913,6.332511243
48095,"Concho County, Texas",NA,2023,3301,312,2989,9.451681309
48097,"Cooke County, Texas",NA,2023,42473,2174,40299,5.1185459
48099,"Coryell County, Texas",NA,2023,83772,2578,81194,3.077400563
48101,"Cottle County, Texas",NA,2023,1302,0,1302,0
48103,"Crane County, Texas",NA,2023,4623,825,3798,17.84555483
48105,"Crockett County, Texas",NA,2023,2881,243,2638,8.434571329
48107,"Crosby County, Texas",NA,2023,5072,177,4895,3.489747634
48109,"Culberson County, Texas",NA,2023,2181,72,2109,3.301237964
48111,"Dallam County, Texas",NA,2023,7180,1562,5618,21.75487465
48113,"Dallas County, Texas",NA,2023,2603816,425153,2178663,16.32807387
48115,"Dawson County, Texas",NA,2023,12311,519,11792,4.215742019
48117,"Deaf Smith County, Texas",NA,2023,18487,2380,16107,12.8739114
48119,"Delta County, Texas",NA,2023,5345,35,5310,0.654817587
48121,"Denton County, Texas",NA,2023,945644,78729,866915,8.32543748
48123,"DeWitt County, Texas",NA,2023,19853,457,19396,2.301919105
48125,"Dickens County, Texas",NA,2023,1641,36,1605,2.193784278
48127,"Dimmit County, Texas",NA,2023,8507,241,8266,2.832961091
48129,"Donley County, Texas",NA,2023,3276,57,3219,1.73992674
48131,"Duval County, Texas",NA,2023,9824,84,9740,0.85504886
48133,"Eastland County, Texas",NA,2023,17846,724,17122,4.056931525
48135,"Ector County, Texas",NA,2023,163206,16619,146587,10.18283642
48137,"Edwards County, Texas",NA,2023,1392,75,1317,5.387931034
48139,"Ellis County, Texas",NA,2023,203927,10191,193736,4.997376512
48141,"El Paso County, Texas",NA,2023,866275,92644,773631,10.69452541
48143,"Erath County, Texas",NA,2023,43244,1963,41281,4.539358061
48145,"Falls County, Texas",NA,2023,17063,658,16405,3.856297251
48147,"Fannin County, Texas",NA,2023,36525,954,35571,2.611909651
48149,"Fayette County, Texas",NA,2023,24783,1197,23586,4.829923738
48151,"Fisher County, Texas",NA,2023,3661,109,3552,2.977328599
48153,"Floyd County, Texas",NA,2023,5294,474,4820,8.953532301
48155,"Foard County, Texas",NA,2023,1079,1,1078,0.092678406
48157,"Fort Bend County, Texas",NA,2023,859721,105741,753980,12.29945529
48159,"Franklin County, Texas",NA,2023,10522,439,10083,4.172210606
48161,"Freestone County, Texas",NA,2023,19813,514,19299,2.594256296
48163,"Frio County, Texas",NA,2023,18019,2618,15401,14.52910816
48165,"Gaines County, Texas",NA,2023,21904,3812,18092,17.40321402
48167,"Galveston County, Texas",NA,2023,354721,17941,336780,5.057777803
48169,"Garza County, Texas",NA,2023,5435,803,4632,14.77460902
48171,"Gillespie County, Texas",NA,2023,27202,1144,26058,4.20557312
48173,"Glasscock County, Texas",NA,2023,1070,88,982,8.224299065
48175,"Goliad County, Texas",NA,2023,7096,211,6885,2.973506201
48177,"Gonzales County, Texas",NA,2023,19764,1447,18317,7.321392431
48179,"Gray County, Texas",NA,2023,21131,1486,19645,7.032322181
48181,"Grayson County, Texas",NA,2023,139988,6735,133253,4.811126668
48183,"Gregg County, Texas",NA,2023,124860,7423,117437,5.945058465
48185,"Grimes County, Texas",NA,2023,30385,1086,29299,3.574131973
48187,"Guadalupe County, Texas",NA,2023,178368,6543,171825,3.668258881
48189,"Hale County, Texas",NA,2023,32247,2030,30217,6.29515924
48191,"Hall County, Texas",NA,2023,2827,199,2628,7.039264238
48193,"Hamilton County, Texas",NA,2023,8320,341,7979,4.098557692
48195,"Hansford County, Texas",NA,2023,5182,557,4625,10.74874566
48197,"Hardeman County, Texas",NA,2023,3529,197,3332,5.582317937
48199,"Hardin County, Texas",NA,2023,57126,514,56612,0.899765431
48201,"Harris County, Texas",NA,2023,4758579,752629,4005950,15.81625523
48203,"Harrison County, Texas",NA,2023,69584,1787,67797,2.568119108
48205,"Hartley County, Texas",NA,2023,5307,397,4910,7.480685887
48207,"Haskell County, Texas",NA,2023,5390,240,5150,4.452690167
48209,"Hays County, Texas",NA,2023,256429,13537,242892,5.279044102
48211,"Hemphill County, Texas",NA,2023,3311,292,3019,8.819087889
48213,"Henderson County, Texas",NA,2023,83658,2502,81156,2.990748046
48215,"Hidalgo County, Texas",NA,2023,880921,156621,724300,17.77923333
48217,"Hill County, Texas",NA,2023,36664,1406,35258,3.834824351
48219,"Hockley County, Texas",NA,2023,21455,1074,20381,5.005826148
48221,"Hood County, Texas",NA,2023,64198,1459,62739,2.272656469
48223,"Hopkins County, Texas",NA,2023,37351,2293,35058,6.139059195
48225,"Houston County, Texas",NA,2023,22042,518,21524,2.350058978
48227,"Howard County, Texas",NA,2023,33127,2778,30349,8.385908775
48229,"Hudspeth County, Texas",NA,2023,3331,860,2471,25.81807265
48231,"Hunt County, Texas",NA,2023,104917,5061,99856,4.823813109
48233,"Hutchinson County, Texas",NA,2023,20413,498,19915,2.43962181
48235,"Irion County, Texas",NA,2023,1432,48,1384,3.351955307
48237,"Jack County, Texas",NA,2023,8623,333,8290,3.861765047
48239,"Jackson County, Texas",NA,2023,15081,491,14590,3.255752271
48241,"Jasper County, Texas",NA,2023,32807,467,32340,1.423476697
48243,"Jeff Davis County, Texas",NA,2023,1740,90,1650,5.172413793
48245,"Jefferson County, Texas",NA,2023,253939,19364,234575,7.625453357
48247,"Jim Hogg County, Texas",NA,2023,4797,30,4767,0.625390869
48249,"Jim Wells County, Texas",NA,2023,38863,739,38124,1.901551604
48251,"Johnson County, Texas",NA,2023,188820,6642,182178,3.517635844
48253,"Jones County, Texas",NA,2023,19968,526,19442,2.634214744
48255,"Karnes County, Texas",NA,2023,14819,686,14133,4.629192253
48257,"Kaufman County, Texas",NA,2023,160718,9156,151562,5.696935004
48259,"Kendall County, Texas",NA,2023,46971,2411,44560,5.132954376
48261,"Kenedy County, Texas",NA,2023,52,9,43,17.30769231
48263,"Kent County, Texas",NA,2023,727,2,725,0.275103164
48265,"Kerr County, Texas",NA,2023,53166,1714,51452,3.223864876
48267,"Kimble County, Texas",NA,2023,4355,189,4166,4.339839265
48269,"King County, Texas",NA,2023,189,26,163,13.75661376
48271,"Kinney County, Texas",NA,2023,3140,162,2978,5.159235669
48273,"Kleberg County, Texas",NA,2023,30629,1117,29512,3.646870613
48275,"Knox County, Texas",NA,2023,3322,121,3201,3.642384106
48277,"Lamar County, Texas",NA,2023,50421,1004,49417,1.991233811
48279,"Lamb County, Texas",NA,2023,12919,1165,11754,9.01772583
48281,"Lampasas County, Texas",NA,2023,22267,683,21584,3.067319352
48283,"La Salle County, Texas",NA,2023,6946,398,6548,5.729916499
48285,"Lavaca County, Texas",NA,2023,20479,885,19594,4.321500073
48287,"Lee County, Texas",NA,2023,17758,873,16885,4.916094155
48289,"Leon County, Texas",NA,2023,16067,567,15500,3.528972428
48291,"Liberty County, Texas",NA,2023,97993,10549,87444,10.76505465
48293,"Limestone County, Texas",NA,2023,22185,1441,20744,6.495379761
48295,"Lipscomb County, Texas",NA,2023,2964,308,2656,10.39136302
48297,"Live Oak County, Texas",NA,2023,11444,775,10669,6.772107655
48299,"Llano County, Texas",NA,2023,22011,495,21516,2.248875562
48301,"Loving County, Texas",NA,2023,54,0,54,0
48303,"Lubbock County, Texas",NA,2023,314633,11399,303234,3.622951184
48305,"Lynn County, Texas",NA,2023,5667,127,5540,2.241044644
48307,"McCulloch County, Texas",NA,2023,7565,333,7232,4.401850628
48309,"McLennan County, Texas",NA,2023,263608,16397,247211,6.220220934
48311,"McMullen County, Texas",NA,2023,623,22,601,3.531300161
48313,"Madison County, Texas",NA,2023,13574,837,12737,6.166200088
48315,"Marion County, Texas",NA,2023,9631,114,9517,1.183677707
48317,"Martin County, Texas",NA,2023,5230,325,4905,6.21414914
48319,"Mason County, Texas",NA,2023,3951,123,3828,3.113135915
48321,"Matagorda County, Texas",NA,2023,36274,2494,33780,6.875447979
48323,"Maverick County, Texas",NA,2023,57770,9731,48039,16.8443829
48325,"Medina County, Texas",NA,2023,52419,1424,50995,2.716572235
48327,"Menard County, Texas",NA,2023,1964,62,1902,3.156822811
48329,"Midland County, Texas",NA,2023,171496,12222,159274,7.126696833
48331,"Milam County, Texas",NA,2023,25268,993,24275,3.929871775
48333,"Mills County, Texas",NA,2023,4499,89,4410,1.978217382
48335,"Mitchell County, Texas",NA,2023,8989,182,8807,2.024696852
48337,"Montague County, Texas",NA,2023,20599,521,20078,2.529248993
48339,"Montgomery County, Texas",NA,2023,654722,56601,598121,8.64504324
48341,"Moore County, Texas",NA,2023,21234,4570,16664,21.52208722
48343,"Morris County, Texas",NA,2023,12014,456,11558,3.795571833
48345,"Motley County, Texas",NA,2023,1267,0,1267,0
48347,"Nacogdoches County, Texas",NA,2023,64897,3431,61466,5.286839145
48349,"Navarro County, Texas",NA,2023,53735,4521,49214,8.413510747
48351,"Newton County, Texas",NA,2023,12193,86,12107,0.705322726
48353,"Nolan County, Texas",NA,2023,14565,205,14360,1.407483694
48355,"Nueces County, Texas",NA,2023,352829,17402,335427,4.932134263
48357,"Ochiltree County, Texas",NA,2023,9852,2241,7611,22.74665043
48359,"Oldham County, Texas",NA,2023,2097,87,2010,4.148783977
48361,"Orange County, Texas",NA,2023,84993,1489,83504,1.751908981
48363,"Palo Pinto County, Texas",NA,2023,28920,1073,27847,3.710235131
48365,"Panola County, Texas",NA,2023,22624,687,21937,3.036598303
48367,"Parker County, Texas",NA,2023,158079,4760,153319,3.011152652
48369,"Parmer County, Texas",NA,2023,9752,1781,7971,18.26292043
48371,"Pecos County, Texas",NA,2023,14983,1023,13960,6.827738103
48373,"Polk County, Texas",NA,2023,51780,1289,50491,2.489378138
48375,"Potter County, Texas",NA,2023,116634,11008,105626,9.438071231
48377,"Presidio County, Texas",NA,2023,6043,960,5083,15.88614926
48379,"Rains County, Texas",NA,2023,12505,223,12282,1.783286685
48381,"Randall County, Texas",NA,2023,143791,3338,140453,2.321424846
48383,"Reagan County, Texas",NA,2023,3259,311,2948,9.542804541
48385,"Real County, Texas",NA,2023,2821,33,2788,1.169797944
48387,"Red River County, Texas",NA,2023,11621,199,11422,1.712417176
48389,"Reeves County, Texas",NA,2023,13219,1494,11725,11.30191391
48391,"Refugio County, Texas",NA,2023,6693,62,6631,0.926340953
48393,"Roberts County, Texas",NA,2023,785,0,785,0
48395,"Robertson County, Texas",NA,2023,16973,625,16348,3.682318977
48397,"Rockwall County, Texas",NA,2023,116931,3926,113005,3.357535641
48399,"Runnels County, Texas",NA,2023,9880,282,9598,2.854251012
48401,"Rusk County, Texas",NA,2023,52613,2129,50484,4.046528425
48403,"Sabine County, Texas",NA,2023,9998,68,9930,0.680136027
48405,"San Augustine County, Texas",NA,2023,7889,293,7596,3.714032197
48407,"San Jacinto County, Texas",NA,2023,27983,1521,26462,5.435442948
48409,"San Patricio County, Texas",NA,2023,69519,2340,67179,3.365986277
48411,"San Saba County, Texas",NA,2023,5802,382,5420,6.583936574
48413,"Schleicher County, Texas",NA,2023,2426,85,2341,3.50370981
48415,"Scurry County, Texas",NA,2023,16633,410,16223,2.464979258
48417,"Shackelford County, Texas",NA,2023,3169,16,3153,0.504891133
48419,"Shelby County, Texas",NA,2023,24108,1204,22904,4.994192799
48421,"Sherman County, Texas",NA,2023,2434,370,2064,15.20131471
48423,"Smith County, Texas",NA,2023,238014,11744,226270,4.934163537
48425,"Somervell County, Texas",NA,2023,9510,614,8896,6.456361725
48427,"Starr County, Texas",NA,2023,65809,12612,53197,19.16455196
48429,"Stephens County, Texas",NA,2023,9278,385,8893,4.149601207
48431,"Sterling County, Texas",NA,2023,1389,104,1285,7.487401008
48433,"Stonewall County, Texas",NA,2023,1244,13,1231,1.045016077
48435,"Sutton County, Texas",NA,2023,3306,246,3060,7.441016334
48437,"Swisher County, Texas",NA,2023,6981,520,6461,7.448789572
48439,"Tarrant County, Texas",NA,2023,2135743,204984,1930759,9.597784003
48441,"Taylor County, Texas",NA,2023,144259,5669,138590,3.929737486
48443,"Terrell County, Texas",NA,2023,851,6,845,0.705052879
48445,"Terry County, Texas",NA,2023,11699,839,10860,7.171553124
48447,"Throckmorton County, Texas",NA,2023,1589,34,1555,2.13971051
48449,"Titus County, Texas",NA,2023,31284,3898,27386,12.46004347
48451,"Tom Green County, Texas",NA,2023,119398,3837,115561,3.213621669
48453,"Travis County, Texas",NA,2023,1307625,132531,1175094,10.1352452
48455,"Trinity County, Texas",NA,2023,13850,348,13502,2.512635379
48457,"Tyler County, Texas",NA,2023,20084,415,19669,2.06632145
48459,"Upshur County, Texas",NA,2023,41864,821,41043,1.961112173
48461,"Upton County, Texas",NA,2023,3227,123,3104,3.811589712
48463,"Uvalde County, Texas",NA,2023,24810,1503,23307,6.058041112
48465,"Val Verde County, Texas",NA,2023,47647,4430,43217,9.297542343
48467,"Van Zandt County, Texas",NA,2023,61323,1644,59679,2.680886454
48469,"Victoria County, Texas",NA,2023,91281,3567,87714,3.907713544
48471,"Walker County, Texas",NA,2023,78292,3854,74438,4.922597456
48473,"Waller County, Texas",NA,2023,59455,4556,54899,7.662938357
48475,"Ward County, Texas",NA,2023,11255,365,10890,3.24300311
48477,"Washington County, Texas",NA,2023,36156,1380,34776,3.816793893
48479,"Webb County, Texas",NA,2023,267731,45536,222195,17.00811636
48481,"Wharton County, Texas",NA,2023,41651,2203,39448,5.289188735
48483,"Wheeler County, Texas",NA,2023,4902,364,4538,7.425540596
48485,"Wichita County, Texas",NA,2023,129842,4856,124986,3.739930069
48487,"Wilbarger County, Texas",NA,2023,12712,364,12348,2.863436123
48489,"Willacy County, Texas",NA,2023,20218,1654,18564,8.180828964
48491,"Williamson County, Texas",NA,2023,643889,50210,593679,7.797927904
48493,"Wilson County, Texas",NA,2023,51501,1462,50039,2.83877983
48495,"Winkler County, Texas",NA,2023,7540,742,6798,9.840848806
48497,"Wise County, Texas",NA,2023,72359,3526,68833,4.872925275
48499,"Wood County, Texas",NA,2023,46094,1162,44932,2.52093548
48501,"Yoakum County, Texas",NA,2023,7589,1277,6312,16.82698643
48503,"Young County, Texas",NA,2023,17963,721,17242,4.013806157
48505,"Zapata County, Texas",NA,2023,13855,2272,11583,16.39841213
48507,"Zavala County, Texas",NA,2023,9532,264,9268,2.769618128
49001,"Beaver County, Utah",NA,2023,7172,314,6858,4.3781372
49003,"Box Elder County, Utah",NA,2023,59725,1066,58659,1.784847216
49005,"Cache County, Utah",NA,2023,137031,5298,131733,3.866278433
49007,"Carbon County, Utah",NA,2023,20446,230,20216,1.124914409
49009,"Daggett County, Utah",NA,2023,747,7,740,0.93708166
49011,"Davis County, Utah",NA,2023,366742,8726,358016,2.379329338
49013,"Duchesne County, Utah",NA,2023,19932,288,19644,1.444912703
49015,"Emery County, Utah",NA,2023,9968,169,9799,1.695425361
49017,"Garfield County, Utah",NA,2023,5170,49,5121,0.947775629
49019,"Grand County, Utah",NA,2023,9697,409,9288,4.217799319
49021,"Iron County, Utah",NA,2023,60201,1028,59173,1.70761283
49023,"Juab County, Utah",NA,2023,12273,32,12241,0.260734947
49025,"Kane County, Utah",NA,2023,7996,41,7955,0.512756378
49027,"Millard County, Utah",NA,2023,13179,587,12592,4.454055695
49029,"Morgan County, Utah",NA,2023,12585,53,12532,0.421136273
49031,"Piute County, Utah",NA,2023,1705,8,1697,0.469208211
49033,"Rich County, Utah",NA,2023,2588,86,2502,3.323029366
49035,"Salt Lake County, Utah",NA,2023,1184689,89294,1095395,7.537336803
49037,"San Juan County, Utah",NA,2023,14466,80,14386,0.553020877
49039,"Sanpete County, Utah",NA,2023,29209,1201,28008,4.11174638
49041,"Sevier County, Utah",NA,2023,21854,186,21668,0.851102773
49043,"Summit County, Utah",NA,2023,42709,2148,40561,5.029384907
49045,"Tooele County, Utah",NA,2023,76648,1167,75481,1.52254462
49047,"Uintah County, Utah",NA,2023,36458,565,35893,1.549728455
49049,"Utah County, Utah",NA,2023,683622,31904,651718,4.666906565
49051,"Wasatch County, Utah",NA,2023,35808,1700,34108,4.747542449
49053,"Washington County, Utah",NA,2023,189827,6481,183346,3.414161315
49055,"Wayne County, Utah",NA,2023,2557,110,2447,4.301916308
49057,"Weber County, Utah",NA,2023,266183,8680,257503,3.260914484
50001,"Addison County, Vermont",NA,2023,37497,983,36514,2.621543057
50003,"Bennington County, Vermont",NA,2023,37312,356,36956,0.954116638
50005,"Caledonia County, Vermont",NA,2023,30425,206,30219,0.677074774
50007,"Chittenden County, Vermont",NA,2023,168831,5237,163594,3.101918487
50009,"Essex County, Vermont",NA,2023,5972,67,5905,1.12190221
50011,"Franklin County, Vermont",NA,2023,50379,473,49906,0.938883265
50013,"Grand Isle County, Vermont",NA,2023,7393,148,7245,2.001893683
50015,"Lamoille County, Vermont",NA,2023,26036,633,25403,2.43124904
50017,"Orange County, Vermont",NA,2023,29594,149,29445,0.503480435
50019,"Orleans County, Vermont",NA,2023,27492,298,27194,1.083951695
50021,"Rutland County, Vermont",NA,2023,60484,411,60073,0.67951855
50023,"Washington County, Vermont",NA,2023,59958,689,59269,1.14913773
50025,"Windham County, Vermont",NA,2023,45913,438,45475,0.953978176
50027,"Windsor County, Vermont",NA,2023,57968,837,57131,1.443900083
51001,"Accomack County, Virginia",NA,2023,33326,2233,31093,6.700474104
51003,"Albemarle County, Virginia",NA,2023,113683,6528,107155,5.742283367
51005,"Alleghany County, Virginia",NA,2023,14962,95,14867,0.634941853
51007,"Amelia County, Virginia",NA,2023,13342,153,13189,1.14675461
51009,"Amherst County, Virginia",NA,2023,31385,184,31201,0.586267325
51011,"Appomattox County, Virginia",NA,2023,16424,150,16274,0.913297613
51013,"Arlington County, Virginia",NA,2023,235463,25024,210439,10.62757206
51015,"Augusta County, Virginia",NA,2023,77713,1326,76387,1.706278229
51017,"Bath County, Virginia",NA,2023,4123,27,4096,0.654862964
51019,"Bedford County, Virginia",NA,2023,80254,1004,79250,1.251027986
51021,"Bland County, Virginia",NA,2023,6211,2,6209,0.032200934
51023,"Botetourt County, Virginia",NA,2023,33875,133,33742,0.392619926
51025,"Brunswick County, Virginia",NA,2023,15868,335,15533,2.111167129
51027,"Buchanan County, Virginia",NA,2023,19857,99,19758,0.498564738
51029,"Buckingham County, Virginia",NA,2023,16914,193,16721,1.141066572
51031,"Campbell County, Virginia",NA,2023,55398,1098,54300,1.982021012
51033,"Caroline County, Virginia",NA,2023,31541,678,30863,2.149583082
51035,"Carroll County, Virginia",NA,2023,29158,387,28771,1.327251526
51036,"Charles City County, Virginia",NA,2023,6686,81,6605,1.211486689
51037,"Charlotte County, Virginia",NA,2023,11475,21,11454,0.183006536
51041,"Chesterfield County, Virginia",NA,2023,371610,17930,353680,4.824950889
51043,"Clarke County, Virginia",NA,2023,15060,434,14626,2.881806109
51045,"Craig County, Virginia",NA,2023,4881,0,4881,0
51047,"Culpeper County, Virginia",NA,2023,53563,3127,50436,5.837985176
51049,"Cumberland County, Virginia",NA,2023,9745,52,9693,0.533606978
51051,"Dickenson County, Virginia",NA,2023,13920,23,13897,0.165229885
51053,"Dinwiddie County, Virginia",NA,2023,28083,447,27636,1.591710287
51057,"Essex County, Virginia",NA,2023,10604,207,10397,1.95209355
51059,"Fairfax County, Virginia",NA,2023,1144474,138707,1005767,12.11971613
51061,"Fauquier County, Virginia",NA,2023,73935,3068,70867,4.149590857
51063,"Floyd County, Virginia",NA,2023,15560,173,15387,1.111825193
51065,"Fluvanna County, Virginia",NA,2023,27764,186,27578,0.669932286
51067,"Franklin County, Virginia",NA,2023,54958,638,54320,1.160886495
51069,"Frederick County, Virginia",NA,2023,93355,4262,89093,4.565368754
51071,"Giles County, Virginia",NA,2023,16610,59,16551,0.355207706
51073,"Gloucester County, Virginia",NA,2023,39228,215,39013,0.548077904
51075,"Goochland County, Virginia",NA,2023,25613,165,25448,0.644204115
51077,"Grayson County, Virginia",NA,2023,15323,70,15253,0.456829603
51079,"Greene County, Virginia",NA,2023,20850,675,20175,3.237410072
51081,"Greensville County, Virginia",NA,2023,11304,256,11048,2.264685067
51083,"Halifax County, Virginia",NA,2023,33811,173,33638,0.5116678
51085,"Hanover County, Virginia",NA,2023,111652,2042,109610,1.82889693
51087,"Henrico County, Virginia",NA,2023,334434,23631,310803,7.065968173
51089,"Henry County, Virginia",NA,2023,50365,549,49816,1.090042688
51091,"Highland County, Virginia",NA,2023,2265,5,2260,0.220750552
51093,"Isle of Wight County, Virginia",NA,2023,39444,318,39126,0.806206267
51095,"James City County, Virginia",NA,2023,80046,2083,77963,2.602253704
51097,"King and Queen County, Virginia",NA,2023,6676,6,6670,0.089874176
51099,"King George County, Virginia",NA,2023,27468,399,27069,1.452599388
51101,"King William County, Virginia",NA,2023,18232,87,18145,0.477182975
51103,"Lancaster County, Virginia",NA,2023,10876,80,10796,0.735564546
51105,"Lee County, Virginia",NA,2023,22042,184,21858,0.834769985
51107,"Loudoun County, Virginia",NA,2023,427082,41473,385609,9.710781536
51109,"Louisa County, Virginia",NA,2023,39012,610,38402,1.56362145
51111,"Lunenburg County, Virginia",NA,2023,11990,330,11660,2.752293578
51113,"Madison County, Virginia",NA,2023,13931,179,13752,1.284904171
51115,"Mathews County, Virginia",NA,2023,8517,10,8507,0.117412234
51117,"Mecklenburg County, Virginia",NA,2023,30431,620,29811,2.037396076
51119,"Middlesex County, Virginia",NA,2023,10774,194,10580,1.800631149
51121,"Montgomery County, Virginia",NA,2023,99159,5905,93254,5.955082242
51125,"Nelson County, Virginia",NA,2023,14777,338,14439,2.287338431
51127,"New Kent County, Virginia",NA,2023,24139,408,23731,1.690210862
51131,"Northampton County, Virginia",NA,2023,12115,441,11674,3.640115559
51133,"Northumberland County, Virginia",NA,2023,12085,28,12057,0.23169218
51135,"Nottoway County, Virginia",NA,2023,15597,218,15379,1.397704687
51137,"Orange County, Virginia",NA,2023,37208,784,36424,2.107073748
51139,"Page County, Virginia",NA,2023,23750,266,23484,1.12
51141,"Patrick County, Virginia",NA,2023,17606,130,17476,0.738384642
51143,"Pittsylvania County, Virginia",NA,2023,60148,395,59753,0.65671344
51145,"Powhatan County, Virginia",NA,2023,31074,348,30726,1.119907318
51147,"Prince Edward County, Virginia",NA,2023,21932,385,21547,1.755425862
51149,"Prince George County, Virginia",NA,2023,42873,970,41903,2.26249621
51153,"Prince William County, Virginia",NA,2023,484625,53732,430893,11.08733557
51155,"Pulaski County, Virginia",NA,2023,33771,73,33698,0.216161796
51157,"Rappahannock County, Virginia",NA,2023,7409,204,7205,2.753408017
51159,"Richmond County, Virginia",NA,2023,9047,261,8786,2.884934232
51161,"Roanoke County, Virginia",NA,2023,96793,2815,93978,2.90826816
51163,"Rockbridge County, Virginia",NA,2023,22578,171,22407,0.757374435
51165,"Rockingham County, Virginia",NA,2023,84739,2804,81935,3.308984057
51167,"Russell County, Virginia",NA,2023,25635,72,25563,0.280866004
51169,"Scott County, Virginia",NA,2023,21504,63,21441,0.29296875
51171,"Shenandoah County, Virginia",NA,2023,44630,1454,43176,3.257898275
51173,"Smyth County, Virginia",NA,2023,29585,386,29199,1.304715227
51175,"Southampton County, Virginia",NA,2023,17988,59,17929,0.327996442
51177,"Spotsylvania County, Virginia",NA,2023,143876,6135,137741,4.264088521
51179,"Stafford County, Virginia",NA,2023,160520,9271,151249,5.775604286
51181,"Surry County, Virginia",NA,2023,6552,58,6494,0.885225885
51183,"Sussex County, Virginia",NA,2023,10793,62,10731,0.5744464
51185,"Tazewell County, Virginia",NA,2023,39933,53,39880,0.13272231
51187,"Warren County, Virginia",NA,2023,41104,1313,39791,3.194336318
51191,"Washington County, Virginia",NA,2023,53913,364,53549,0.675161835
51193,"Westmoreland County, Virginia",NA,2023,18683,347,18336,1.857303431
51195,"Wise County, Virginia",NA,2023,35727,217,35510,0.607383771
51197,"Wythe County, Virginia",NA,2023,28219,171,28048,0.605974698
51199,"York County, Virginia",NA,2023,70590,1653,68937,2.341691458
51510,"Alexandria city, Virginia",NA,2023,156788,19950,136838,12.72418808
51520,"Bristol city, Virginia",NA,2023,17024,35,16989,0.205592105
51530,"Buena Vista city, Virginia",NA,2023,6612,0,6612,0
51540,"Charlottesville city, Virginia",NA,2023,45863,2698,43165,5.882737719
51550,"Chesapeake city, Virginia",NA,2023,251153,5883,245270,2.342396866
51570,"Colonial Heights city, Virginia",NA,2023,18210,571,17639,3.135639758
51580,"Covington city, Virginia",NA,2023,5671,126,5545,2.221830365
51590,"Danville city, Virginia",NA,2023,42239,1252,40987,2.964085324
51595,"Emporia city, Virginia",NA,2023,5633,156,5477,2.769394639
51600,"Fairfax city, Virginia",NA,2023,24478,3528,20950,14.41294223
51610,"Falls Church city, Virginia",NA,2023,14593,710,13883,4.865346399
51620,"Franklin city, Virginia",NA,2023,8212,60,8152,0.730638091
51630,"Fredericksburg city, Virginia",NA,2023,28383,2252,26131,7.934326886
51640,"Galax city, Virginia",NA,2023,6698,213,6485,3.180053747
51650,"Hampton city, Virginia",NA,2023,137334,1576,135758,1.147567245
51660,"Harrisonburg city, Virginia",NA,2023,51492,5577,45915,10.83080867
51670,"Hopewell city, Virginia",NA,2023,22944,365,22579,1.590829847
51678,"Lexington city, Virginia",NA,2023,7420,212,7208,2.857142857
51680,"Lynchburg city, Virginia",NA,2023,79255,2159,77096,2.724118352
51683,"Manassas city, Virginia",NA,2023,42674,7615,35059,17.84458921
51685,"Manassas Park city, Virginia",NA,2023,16923,2952,13971,17.44371565
51690,"Martinsville city, Virginia",NA,2023,13584,574,13010,4.225559482
51700,"Newport News city, Virginia",NA,2023,184774,6613,178161,3.578966738
51710,"Norfolk city, Virginia",NA,2023,235037,8316,226721,3.538166331
51720,"Norton city, Virginia",NA,2023,3620,0,3620,0
51730,"Petersburg city, Virginia",NA,2023,33365,652,32713,1.954143564
51735,"Poquoson city, Virginia",NA,2023,12556,128,12428,1.01943294
51740,"Portsmouth city, Virginia",NA,2023,97299,1332,95967,1.368976043
51750,"Radford city, Virginia",NA,2023,16505,147,16358,0.8906392
51760,"Richmond city, Virginia",NA,2023,227595,13599,213996,5.975087326
51770,"Roanoke city, Virginia",NA,2023,98677,4743,93934,4.806591202
51775,"Salem city, Virginia",NA,2023,25477,651,24826,2.555245908
51790,"Staunton city, Virginia",NA,2023,25765,617,25148,2.394721521
51800,"Suffolk city, Virginia",NA,2023,96638,1629,95009,1.685672303
51810,"Virginia Beach city, Virginia",NA,2023,457066,14701,442365,3.216384505
51820,"Waynesboro city, Virginia",NA,2023,22574,553,22021,2.449720918
51830,"Williamsburg city, Virginia",NA,2023,15564,777,14787,4.9922899
51840,"Winchester city, Virginia",NA,2023,27981,2551,25430,9.116900754
53001,"Adams County, Washington",NA,2023,20690,3692,16998,17.84436926
53003,"Asotin County, Washington",NA,2023,22424,349,22075,1.556368177
53005,"Benton County, Washington",NA,2023,210224,13877,196347,6.601054114
53007,"Chelan County, Washington",NA,2023,79518,7519,71999,9.455720717
53009,"Clallam County, Washington",NA,2023,77593,1175,76418,1.514311858
53011,"Clark County, Washington",NA,2023,510516,24218,486298,4.743827813
53013,"Columbia County, Washington",NA,2023,3996,107,3889,2.677677678
53015,"Cowlitz County, Washington",NA,2023,111539,2474,109065,2.218058258
53017,"Douglas County, Washington",NA,2023,43733,5365,38368,12.26762399
53019,"Ferry County, Washington",NA,2023,7326,89,7237,1.214851215
53021,"Franklin County, Washington",NA,2023,97676,14173,83503,14.51021745
53023,"Garfield County, Washington",NA,2023,2326,37,2289,1.590713672
53025,"Grant County, Washington",NA,2023,100428,12164,88264,12.11215996
53027,"Grays Harbor County, Washington",NA,2023,76397,2556,73841,3.345681113
53029,"Island County, Washington",NA,2023,86747,2232,84515,2.572999643
53031,"Jefferson County, Washington",NA,2023,33313,822,32491,2.467505178
53033,"King County, Washington",NA,2023,2262713,298193,1964520,13.17856043
53035,"Kitsap County, Washington",NA,2023,276581,7663,268918,2.770616926
53037,"Kittitas County, Washington",NA,2023,44736,897,43839,2.005096567
53039,"Klickitat County, Washington",NA,2023,23082,1189,21893,5.151200069
53041,"Lewis County, Washington",NA,2023,83925,2533,81392,3.018170986
53043,"Lincoln County, Washington",NA,2023,11271,104,11167,0.92272203
53045,"Mason County, Washington",NA,2023,66968,3102,63866,4.632063075
53047,"Okanogan County, Washington",NA,2023,42811,3954,38857,9.235944033
53049,"Pacific County, Washington",NA,2023,23750,675,23075,2.842105263
53051,"Pend Oreille County, Washington",NA,2023,13811,99,13712,0.716819926
53053,"Pierce County, Washington",NA,2023,924106,41643,882463,4.506301225
53055,"San Juan County, Washington",NA,2023,18266,617,17649,3.377860506
53057,"Skagit County, Washington",NA,2023,130407,6671,123736,5.11552294
53059,"Skamania County, Washington",NA,2023,12276,265,12011,2.15868361
53061,"Snohomish County, Washington",NA,2023,834648,75507,759141,9.046568134
53063,"Spokane County, Washington",NA,2023,544323,11950,532373,2.195387665
53065,"Stevens County, Washington",NA,2023,47470,276,47194,0.581419844
53067,"Thurston County, Washington",NA,2023,296640,10487,286153,3.535261597
53069,"Wahkiakum County, Washington",NA,2023,4573,95,4478,2.07741089
53071,"Walla Walla County, Washington",NA,2023,62102,3010,59092,4.846864835
53073,"Whatcom County, Washington",NA,2023,228432,10118,218314,4.429326889
53075,"Whitman County, Washington",NA,2023,47042,2524,44518,5.365418137
53077,"Yakima County, Washington",NA,2023,256605,32286,224319,12.58198398
54001,"Barbour County, West Virginia",NA,2023,15454,63,15391,0.407661447
54003,"Berkeley County, West Virginia",NA,2023,126165,1950,124215,1.545595054
54005,"Boone County, West Virginia",NA,2023,21312,38,21274,0.178303303
54007,"Braxton County, West Virginia",NA,2023,12345,5,12340,0.040502228
54009,"Brooke County, West Virginia",NA,2023,22053,169,21884,0.766335646
54011,"Cabell County, West Virginia",NA,2023,93300,610,92690,0.65380493
54013,"Calhoun County, West Virginia",NA,2023,6158,2,6156,0.032478077
54015,"Clay County, West Virginia",NA,2023,7946,0,7946,0
54017,"Doddridge County, West Virginia",NA,2023,7767,14,7753,0.180249775
54019,"Fayette County, West Virginia",NA,2023,39987,112,39875,0.28009103
54021,"Gilmer County, West Virginia",NA,2023,7376,247,7129,3.348698482
54023,"Grant County, West Virginia",NA,2023,10972,24,10948,0.218738607
54025,"Greenbrier County, West Virginia",NA,2023,32688,208,32480,0.636319139
54027,"Hampshire County, West Virginia",NA,2023,23340,42,23298,0.179948586
54029,"Hancock County, West Virginia",NA,2023,28658,124,28534,0.432688952
54031,"Hardy County, West Virginia",NA,2023,14236,183,14053,1.285473448
54033,"Harrison County, West Virginia",NA,2023,65407,223,65184,0.340942101
54035,"Jackson County, West Virginia",NA,2023,27753,330,27423,1.189060642
54037,"Jefferson County, West Virginia",NA,2023,58546,1400,57146,2.391282069
54039,"Kanawha County, West Virginia",NA,2023,178198,1288,176910,0.722791502
54041,"Lewis County, West Virginia",NA,2023,16808,0,16808,0
54043,"Lincoln County, West Virginia",NA,2023,20170,27,20143,0.133862172
54045,"Logan County, West Virginia",NA,2023,31826,2,31824,0.00628417
54047,"McDowell County, West Virginia",NA,2023,18413,242,18171,1.314288818
54049,"Marion County, West Virginia",NA,2023,56042,265,55777,0.472859641
54051,"Marshall County, West Virginia",NA,2023,30129,46,30083,0.152676823
54053,"Mason County, West Virginia",NA,2023,25214,22,25192,0.087253113
54055,"Mercer County, West Virginia",NA,2023,59062,225,58837,0.380955606
54057,"Mineral County, West Virginia",NA,2023,26922,74,26848,0.274868138
54059,"Mingo County, West Virginia",NA,2023,22979,21,22958,0.091387789
54061,"Monongalia County, West Virginia",NA,2023,106520,3185,103335,2.990048817
54063,"Monroe County, West Virginia",NA,2023,12401,2,12399,0.016127732
54065,"Morgan County, West Virginia",NA,2023,17327,127,17200,0.73296012
54067,"Nicholas County, West Virginia",NA,2023,24446,129,24317,0.527693692
54069,"Ohio County, West Virginia",NA,2023,41904,483,41421,1.152634593
54071,"Pendleton County, West Virginia",NA,2023,6111,5,6106,0.081819669
54073,"Pleasants County, West Virginia",NA,2023,7572,0,7572,0
54075,"Pocahontas County, West Virginia",NA,2023,7855,10,7845,0.127307447
54077,"Preston County, West Virginia",NA,2023,34204,392,33812,1.146064788
54079,"Putnam County, West Virginia",NA,2023,57250,335,56915,0.585152838
54081,"Raleigh County, West Virginia",NA,2023,73666,400,73266,0.542991339
54083,"Randolph County, West Virginia",NA,2023,27782,24,27758,0.086386869
54085,"Ritchie County, West Virginia",NA,2023,8372,49,8323,0.585284281
54087,"Roane County, West Virginia",NA,2023,13921,30,13891,0.21550176
54089,"Summers County, West Virginia",NA,2023,11833,20,11813,0.169018846
54091,"Taylor County, West Virginia",NA,2023,16543,16,16527,0.096717645
54093,"Tucker County, West Virginia",NA,2023,6698,12,6686,0.179157958
54095,"Tyler County, West Virginia",NA,2023,8181,0,8181,0
54097,"Upshur County, West Virginia",NA,2023,23758,99,23659,0.416701743
54099,"Wayne County, West Virginia",NA,2023,38498,247,38251,0.641591771
54101,"Webster County, West Virginia",NA,2023,8253,0,8253,0
54103,"Wetzel County, West Virginia",NA,2023,14233,39,14194,0.274011101
54105,"Wirt County, West Virginia",NA,2023,5131,0,5131,0
54107,"Wood County, West Virginia",NA,2023,83829,306,83523,0.365028809
54109,"Wyoming County, West Virginia",NA,2023,20948,27,20921,0.128890586
55001,"Adams County, Wisconsin",NA,2023,20928,224,20704,1.070336391
55003,"Ashland County, Wisconsin",NA,2023,16050,126,15924,0.785046729
55005,"Barron County, Wisconsin",NA,2023,46741,494,46247,1.056887957
55007,"Bayfield County, Wisconsin",NA,2023,16410,74,16336,0.450944546
55009,"Brown County, Wisconsin",NA,2023,269425,8266,261159,3.068015218
55011,"Buffalo County, Wisconsin",NA,2023,13341,114,13227,0.854508658
55013,"Burnett County, Wisconsin",NA,2023,16741,62,16679,0.370348247
55015,"Calumet County, Wisconsin",NA,2023,52626,963,51663,1.829893969
55017,"Chippewa County, Wisconsin",NA,2023,66558,312,66246,0.468764085
55019,"Clark County, Wisconsin",NA,2023,34736,818,33918,2.354905573
55021,"Columbia County, Wisconsin",NA,2023,58322,684,57638,1.172799287
55023,"Crawford County, Wisconsin",NA,2023,16064,156,15908,0.971115538
55025,"Dane County, Wisconsin",NA,2023,564777,28833,535944,5.105200814
55027,"Dodge County, Wisconsin",NA,2023,88818,1318,87500,1.483933437
55029,"Door County, Wisconsin",NA,2023,30279,377,29902,1.245087354
55031,"Douglas County, Wisconsin",NA,2023,44197,358,43839,0.810009729
55033,"Dunn County, Wisconsin",NA,2023,45349,473,44876,1.043021897
55035,"Eau Claire County, Wisconsin",NA,2023,106328,1432,104896,1.346776014
55037,"Florence County, Wisconsin",NA,2023,4617,1,4616,0.021659086
55039,"Fond du Lac County, Wisconsin",NA,2023,104053,2110,101943,2.027812749
55041,"Forest County, Wisconsin",NA,2023,9261,15,9246,0.16196955
55043,"Grant County, Wisconsin",NA,2023,51678,380,51298,0.735322574
55045,"Green County, Wisconsin",NA,2023,37036,329,36707,0.888324873
55047,"Green Lake County, Wisconsin",NA,2023,19165,150,19015,0.782676755
55049,"Iowa County, Wisconsin",NA,2023,23832,197,23635,0.826619671
55051,"Iron County, Wisconsin",NA,2023,6164,25,6139,0.405580792
55053,"Jackson County, Wisconsin",NA,2023,20971,132,20839,0.629440656
55055,"Jefferson County, Wisconsin",NA,2023,85867,2006,83861,2.336171055
55057,"Juneau County, Wisconsin",NA,2023,26695,280,26415,1.048885559
55059,"Kenosha County, Wisconsin",NA,2023,168413,6494,161919,3.855996865
55061,"Kewaunee County, Wisconsin",NA,2023,20621,336,20285,1.629406915
55063,"La Crosse County, Wisconsin",NA,2023,120262,947,119315,0.787447406
55065,"Lafayette County, Wisconsin",NA,2023,16788,469,16319,2.79366214
55067,"Langlade County, Wisconsin",NA,2023,19473,100,19373,0.513531557
55069,"Lincoln County, Wisconsin",NA,2023,28403,198,28205,0.69710946
55071,"Manitowoc County, Wisconsin",NA,2023,81314,1501,79813,1.84593059
55073,"Marathon County, Wisconsin",NA,2023,138067,2562,135505,1.855620822
55075,"Marinette County, Wisconsin",NA,2023,41907,366,41541,0.873362445
55077,"Marquette County, Wisconsin",NA,2023,15706,116,15590,0.738571247
55078,"Menominee County, Wisconsin",NA,2023,4256,5,4251,0.117481203
55079,"Milwaukee County, Wisconsin",NA,2023,927656,49359,878297,5.320830135
55081,"Monroe County, Wisconsin",NA,2023,46169,610,45559,1.321232862
55083,"Oconto County, Wisconsin",NA,2023,39329,151,39178,0.383940604
55085,"Oneida County, Wisconsin",NA,2023,38007,246,37761,0.647249191
55087,"Outagamie County, Wisconsin",NA,2023,191537,3646,187891,1.903548662
55089,"Ozaukee County, Wisconsin",NA,2023,92345,1583,90762,1.714223835
55091,"Pepin County, Wisconsin",NA,2023,7372,73,7299,0.990233315
55093,"Pierce County, Wisconsin",NA,2023,42351,534,41817,1.260891124
55095,"Polk County, Wisconsin",NA,2023,45327,176,45151,0.38828954
55097,"Portage County, Wisconsin",NA,2023,70375,903,69472,1.28312611
55099,"Price County, Wisconsin",NA,2023,14077,136,13941,0.966114939
55101,"Racine County, Wisconsin",NA,2023,196888,5374,191514,2.729470562
55103,"Richland County, Wisconsin",NA,2023,17229,215,17014,1.247895989
55105,"Rock County, Wisconsin",NA,2023,163944,4724,159220,2.881471722
55107,"Rusk County, Wisconsin",NA,2023,14146,41,14105,0.289834582
55109,"St. Croix County, Wisconsin",NA,2023,94819,952,93867,1.004018182
55111,"Sauk County, Wisconsin",NA,2023,65759,1377,64382,2.094009945
55113,"Sawyer County, Wisconsin",NA,2023,18243,123,18120,0.674231212
55115,"Shawano County, Wisconsin",NA,2023,40927,163,40764,0.398270091
55117,"Sheboygan County, Wisconsin",NA,2023,117783,3015,114768,2.55979216
55119,"Taylor County, Wisconsin",NA,2023,19972,220,19752,1.101542159
55121,"Trempealeau County, Wisconsin",NA,2023,30786,1380,29406,4.482557006
55123,"Vernon County, Wisconsin",NA,2023,30915,160,30755,0.517548116
55125,"Vilas County, Wisconsin",NA,2023,23410,90,23320,0.384451089
55127,"Walworth County, Wisconsin",NA,2023,105447,3574,101873,3.389380447
55129,"Washburn County, Wisconsin",NA,2023,16749,123,16626,0.734372201
55131,"Washington County, Wisconsin",NA,2023,137320,1681,135639,1.224147976
55133,"Waukesha County, Wisconsin",NA,2023,409040,9023,400017,2.205896734
55135,"Waupaca County, Wisconsin",NA,2023,51714,275,51439,0.531770894
55137,"Waushara County, Wisconsin",NA,2023,24752,312,24440,1.260504202
55139,"Winnebago County, Wisconsin",NA,2023,171357,2727,168630,1.591414416
55141,"Wood County, Wisconsin",NA,2023,74039,884,73155,1.193965343
56001,"Albany County, Wyoming",NA,2023,37713,1971,35742,5.226314533
56003,"Big Horn County, Wyoming",NA,2023,11737,239,11498,2.036295476
56005,"Campbell County, Wyoming",NA,2023,47018,938,46080,1.994980646
56007,"Carbon County, Wyoming",NA,2023,14549,499,14050,3.429788989
56009,"Converse County, Wyoming",NA,2023,13759,157,13602,1.141071299
56011,"Crook County, Wyoming",NA,2023,7339,67,7272,0.912930917
56013,"Fremont County, Wyoming",NA,2023,39472,240,39232,0.608025942
56015,"Goshen County, Wyoming",NA,2023,12587,103,12484,0.8183046
56017,"Hot Springs County, Wyoming",NA,2023,4618,18,4600,0.389779125
56019,"Johnson County, Wyoming",NA,2023,8602,93,8509,1.08114392
56021,"Laramie County, Wyoming",NA,2023,100661,1600,99061,1.589493448
56023,"Lincoln County, Wyoming",NA,2023,20158,364,19794,1.805734696
56025,"Natrona County, Wyoming",NA,2023,79735,820,78915,1.028406597
56027,"Niobrara County, Wyoming",NA,2023,2415,0,2415,0
56029,"Park County, Wyoming",NA,2023,30109,212,29897,0.704108406
56031,"Platte County, Wyoming",NA,2023,8606,48,8558,0.557750407
56033,"Sheridan County, Wyoming",NA,2023,31585,294,31291,0.930821593
56035,"Sublette County, Wyoming",NA,2023,8806,214,8592,2.430161254
56037,"Sweetwater County, Wyoming",NA,2023,41786,1505,40281,3.601684775
56039,"Teton County, Wyoming",NA,2023,23358,1966,21392,8.416816508
56041,"Uinta County, Wyoming",NA,2023,20605,202,20403,0.980344577
56043,"Washakie County, Wyoming",NA,2023,7708,106,7602,1.375194603
56045,"Weston County, Wyoming",NA,2023,6835,98,6737,1.433796635